TILEMAP
200 20        -- Size of tile map in tiles
16 16        -- Tile size & block size
textures/green_tile.png  -- Tilesheet
32 32         -- Number of tiles in tilesheet
29 30 0 0 0 0 0 0 0 0 0 0 0 0 0 0 0 0 25 26 29 30 0 0 0 0 0 0 0 0 0 0 0 0 0 0 0 0 25 26 29 30 0 0 0 0 0 0 0 0 0 0 0 0 0 0 0 0 25 26 0 0 0 0 0 0 0 0 0 0 0 0 0 0 0 0 0 0 0 0 0 0 0 0 0 0 0 0 0 0 0 0 0 0 0 0 0 0 0 0 0 0 0 0 624 562 554 555 556 557 558 559 554 555 556 557 558 559 554 555 556 557 558 559 554 555 556 557 558 559 554 555 556 557 558 559 554 555 556 557 558 559 452 453 452 453 452 453 452 453 452 453 452 453 452 453 452 453 452 453 781 781 781 781 781 781 781 781 781 781 781 781 781 781 781 781 781 781 781 781 626 0 0 0 0 0 0 0 0 0 0 0 0 0 0 0 0 0 0 0
61 62 29 30 0 0 0 0 0 0 0 0 0 0 0 0 25 26 57 58 61 62 29 30 0 0 0 0 0 0 0 0 0 0 0 0 25 26 57 58 61 62 29 30 0 0 0 0 0 0 0 0 0 0 0 0 25 26 57 58 0 0 0 0 0 0 0 0 0 0 0 0 0 0 0 0 0 0 0 0 0 0 0 0 0 0 0 0 0 0 0 0 0 0 0 0 0 0 0 0 0 0 0 0 656 594 586 587 588 589 590 591 586 587 588 589 590 591 586 587 588 589 590 591 586 587 588 589 590 591 586 587 588 589 590 591 586 587 588 589 590 591 484 485 484 485 484 485 484 485 484 485 484 485 484 485 484 485 484 485 781 781 781 781 781 781 781 781 781 781 781 781 781 781 781 781 781 781 781 781 658 0 0 0 0 0 0 0 0 0 0 0 0 0 0 0 0 0 0 0
0 0 61 62 29 30 0 0 0 0 0 0 0 0 25 26 57 58 0 0 0 0 61 62 29 30 0 0 0 0 0 0 0 0 25 26 57 58 0 0 0 0 61 62 29 30 0 0 0 0 0 0 0 0 25 26 57 58 0 0 0 0 0 0 0 0 0 0 0 0 0 0 0 0 0 0 0 0 0 0 0 0 0 0 0 0 0 0 0 0 0 0 0 0 0 0 0 0 0 0 0 0 0 0 688 562 562 562 562 562 0 0 0 0 0 0 0 0 0 0 0 0 0 0 0 0 0 0 0 0 0 265 622 265 0 0 0 0 0 0 0 0 0 0 0 0 0 0 0 0 0 0 0 0 0 0 0 0 0 0 0 0 0 0 0 0 0 0 0 0 0 0 0 0 0 0 0 0 0 0 690 0 0 0 0 0 0 0 0 0 0 0 0 0 0 0 0 0 0 0
0 0 0 0 61 62 29 30 0 0 0 0 25 26 57 58 0 0 0 0 0 0 0 0 61 62 29 30 0 0 0 0 25 26 57 58 0 0 0 0 0 0 0 0 61 62 29 30 0 0 0 0 25 26 57 58 0 0 0 0 0 0 0 0 0 0 0 0 0 0 0 0 0 0 0 0 0 0 0 0 0 0 0 0 0 0 0 0 0 0 0 0 0 0 0 0 0 0 0 0 0 0 0 0 624 594 594 594 594 594 0 0 0 0 0 0 0 0 0 0 0 0 0 0 0 0 0 0 0 0 0 265 654 265 0 0 0 0 0 0 0 0 0 0 0 0 0 0 0 0 0 0 0 0 0 0 0 0 0 0 0 0 0 0 0 0 0 0 0 0 0 0 0 0 0 0 0 0 0 0 626 0 0 0 0 0 0 0 0 0 0 0 0 0 0 0 0 0 0 0
0 0 0 0 0 0 61 62 29 30 25 26 57 58 0 0 0 0 0 0 0 0 0 0 0 0 61 62 29 30 25 26 57 58 0 0 0 0 0 0 0 0 0 0 0 0 61 62 29 30 25 26 57 58 0 0 0 0 0 0 0 0 0 0 0 0 0 0 0 0 0 0 0 0 0 0 0 0 0 0 0 0 0 0 0 0 0 0 0 0 0 0 0 0 0 0 0 0 0 0 0 0 0 0 656 562 562 562 562 562 0 0 0 0 0 0 0 0 0 0 0 0 0 0 0 0 0 0 0 0 0 265 686 265 0 0 0 0 0 0 0 0 0 0 0 0 0 0 0 0 0 0 0 0 0 0 0 0 0 0 0 0 0 0 0 0 0 0 0 0 0 0 0 0 0 0 0 0 0 0 658 0 0 0 0 0 0 0 0 0 0 0 0 0 0 0 0 0 0 0
0 0 0 0 0 0 0 0 61 62 57 58 0 0 0 0 0 0 0 0 0 0 0 0 0 0 0 0 61 62 57 58 0 0 0 0 0 0 0 0 0 0 0 0 0 0 0 0 61 62 57 58 0 0 0 0 0 0 0 0 0 0 0 0 0 0 0 0 0 0 0 0 0 0 0 0 0 0 0 0 0 0 0 0 0 0 0 0 0 0 0 0 0 0 0 0 0 0 0 0 0 0 0 0 688 594 594 594 594 594 0 0 0 0 0 0 0 0 0 0 0 0 0 0 0 0 0 0 0 0 0 265 718 265 0 0 0 0 0 0 0 0 0 0 0 0 0 0 0 0 0 0 0 0 0 0 0 0 0 0 0 0 0 0 0 0 0 0 0 0 0 0 0 0 0 0 0 0 0 0 690 0 0 0 0 0 0 0 0 0 0 0 0 0 0 0 0 0 0 0
139 139 139 139 139 139 139 139 139 139 139 139 139 139 139 139 139 139 139 139 139 139 139 139 139 139 139 139 139 139 139 139 139 139 139 139 139 139 139 139 139 139 139 139 139 139 139 139 139 139 139 0 0 0 0 0 0 0 0 0 0 0 0 0 0 0 0 0 0 0 0 0 0 0 0 0 0 0 0 0 0 0 0 0 0 0 0 0 0 0 0 0 0 0 0 0 0 0 0 0 0 0 0 0 0 0 0 0 0 0 0 0 0 0 0 0 0 0 0 0 0 0 0 0 0 0 0 0 0 0 0 265 622 265 0 0 0 0 0 0 0 0 0 0 0 0 0 0 0 0 0 0 0 0 0 0 0 0 0 0 0 0 0 0 0 0 0 0 0 0 0 0 0 0 0 0 0 0 0 0 626 0 0 0 0 0 0 0 0 0 0 0 0 0 0 0 0 0 0 0
333 333 333 333 333 333 333 333 333 333 333 333 333 333 333 333 333 333 333 333 333 333 333 333 333 333 333 333 333 333 333 333 333 333 333 333 333 333 333 333 333 333 333 333 333 333 333 333 333 333 333 0 0 0 0 0 0 0 0 0 0 0 0 0 0 0 0 0 0 0 0 0 0 0 0 0 0 0 0 0 0 0 0 0 0 0 0 0 0 0 0 0 0 0 0 0 0 0 0 0 0 0 0 0 0 0 0 0 0 0 0 0 0 0 0 0 0 0 0 0 0 0 0 0 0 0 0 0 0 0 0 265 654 265 0 0 0 0 0 0 0 0 0 0 0 0 0 0 0 0 0 0 0 0 0 0 0 0 0 0 0 0 0 0 0 0 0 0 0 0 0 0 0 0 0 0 0 0 0 0 658 0 0 0 0 0 0 0 0 0 0 0 0 0 0 0 0 0 0 0
0 0 0 0 0 0 0 0 0 0 233 0 0 0 0 0 0 0 0 0 0 0 0 0 0 233 0 0 0 0 0 233 0 0 0 0 0 265 0 0 0 0 0 0 265 0 0 0 0 0 0 0 0 0 0 0 0 0 0 0 0 0 0 0 0 0 0 0 0 0 0 0 0 0 0 0 0 0 0 0 0 0 0 0 0 0 0 0 0 0 0 0 0 0 0 0 0 0 0 0 0 0 0 0 0 0 0 0 0 0 0 0 0 0 0 0 0 0 0 0 0 0 0 0 0 0 0 0 0 0 0 265 686 265 0 0 0 0 0 0 0 0 0 0 0 0 0 0 0 0 0 0 0 0 0 0 0 0 0 0 0 0 0 0 0 0 0 0 0 0 0 0 0 0 0 0 0 0 0 0 690 0 0 0 0 0 0 0 0 0 0 0 0 0 0 0 0 0 0 0
0 0 0 0 0 0 0 0 0 0 0 0 0 0 0 0 0 0 0 0 0 0 0 0 0 0 0 0 0 0 0 0 0 0 0 0 0 0 0 0 0 0 0 0 0 0 0 0 0 0 0 0 0 0 0 0 0 0 0 0 0 0 0 0 0 0 0 0 0 0 0 0 0 0 0 0 0 0 0 0 0 0 0 0 0 0 0 0 0 0 0 0 0 0 0 0 0 0 0 0 0 0 0 0 624 752 752 753 752 753 752 753 752 753 752 753 752 753 753 0 0 0 0 0 0 0 0 0 0 0 0 265 718 265 0 0 0 0 0 0 0 0 0 0 0 0 0 0 0 0 0 0 0 0 0 0 0 0 0 0 0 0 0 0 0 0 0 0 0 0 0 0 0 0 0 0 0 0 0 0 626 0 0 0 0 0 0 0 0 0 0 0 0 0 0 0 0 0 0 0
0 0 0 0 0 0 0 0 0 0 0 0 0 0 0 0 0 0 0 0 0 0 0 0 0 0 0 0 0 0 0 0 0 0 0 0 0 0 0 0 0 0 0 0 0 0 0 0 0 0 0 0 0 0 0 0 0 0 0 0 0 0 0 0 0 0 0 0 0 0 0 0 0 0 0 0 0 0 0 0 0 0 0 0 0 0 0 0 0 0 0 0 0 0 0 0 0 0 0 0 0 0 0 0 656 784 784 785 784 785 784 785 784 785 784 785 784 785 785 0 0 0 0 0 0 0 0 0 0 0 0 0 0 0 0 0 0 0 0 0 0 0 0 0 0 0 0 0 0 0 0 0 0 0 0 0 0 0 0 0 0 0 0 0 0 0 0 0 0 0 0 0 0 0 0 0 0 0 0 0 658 0 0 0 0 0 0 0 0 0 0 0 0 0 0 0 0 0 0 0
0 0 0 0 0 0 0 0 0 0 233 0 0 0 0 0 0 0 0 0 0 0 0 0 0 233 0 0 0 0 0 233 0 0 0 0 0 265 0 0 0 0 0 0 265 0 0 0 0 0 0 0 0 0 0 0 0 0 0 0 0 0 0 0 0 0 0 0 0 0 0 0 0 0 0 0 0 0 0 0 0 0 0 0 0 0 0 0 0 0 0 0 0 0 0 0 0 0 0 0 0 0 0 0 688 752 618 619 620 621 618 619 620 621 618 619 620 621 690 0 0 0 0 0 0 0 0 0 0 0 0 0 0 0 0 0 0 0 0 0 0 0 0 0 0 0 0 0 0 0 0 0 0 0 0 0 0 0 0 0 0 0 0 0 0 0 0 0 0 0 0 0 0 0 0 0 0 0 0 0 690 0 0 0 0 0 0 0 0 0 0 0 0 0 0 0 0 0 0 0
364 364 364 364 364 364 364 364 364 364 364 364 364 364 364 364 364 364 364 364 364 364 364 364 364 364 364 364 364 364 364 364 364 364 364 364 364 364 364 364 364 364 364 364 364 364 364 364 364 364 364 0 0 0 0 0 0 0 0 0 0 0 0 0 0 0 0 0 0 0 0 0 0 0 0 0 0 0 0 0 0 0 0 0 0 0 0 0 0 0 0 0 0 0 0 0 0 0 0 0 0 0 0 0 624 784 650 651 652 653 650 651 652 653 650 651 652 653 626 0 0 0 0 0 0 0 0 0 0 0 0 265 622 265 0 0 0 0 0 0 0 0 0 0 0 0 0 0 0 0 0 0 0 0 0 0 0 0 0 0 0 0 0 0 0 0 0 0 0 0 0 0 0 0 0 0 0 0 0 0 626 0 0 0 0 0 0 0 0 0 0 0 0 0 0 0 0 0 0 0
385 386 387 385 386 387 385 386 387 385 386 387 385 386 387 385 386 387 385 386 387 385 386 387 385 386 387 385 386 387 385 386 387 385 386 387 385 386 387 385 386 387 385 386 387 385 386 387 385 386 387 0 0 0 0 0 0 0 0 0 0 0 0 0 0 0 0 0 0 0 0 0 0 0 0 0 0 0 0 0 0 0 0 0 0 0 0 0 0 0 0 0 89 90 91 92 0 0 0 0 0 0 0 0 656 752 682 683 684 685 682 683 684 685 682 683 684 685 658 0 0 0 0 0 0 0 0 0 0 0 0 265 686 265 0 0 0 0 0 0 0 0 0 0 0 0 0 0 0 0 0 0 0 0 0 0 0 0 0 0 0 0 0 0 0 0 0 0 0 0 0 0 0 0 0 0 0 0 0 0 658 0 0 0 0 0 0 0 0 0 0 0 0 0 0 0 0 0 0 0
0 0 0 0 0 0 0 0 25 26 29 30 0 0 0 0 0 0 0 0 0 0 0 0 0 0 0 0 25 26 29 30 0 0 0 0 0 0 0 0 0 0 0 0 0 0 0 0 25 26 29 30 0 0 0 0 0 0 0 0 0 0 0 0 0 0 0 0 0 0 0 0 0 0 0 0 0 0 0 0 0 0 0 0 0 0 0 0 0 0 89 90 121 122 123 124 91 92 0 0 0 0 0 0 688 784 714 715 716 717 714 715 716 717 714 715 716 717 690 0 0 0 0 0 0 0 0 0 0 0 0 265 718 265 0 0 0 0 0 0 0 0 0 0 0 0 0 0 0 0 0 0 0 0 0 0 0 0 0 0 0 0 0 0 0 0 0 0 0 0 0 0 0 0 0 0 0 0 0 0 690 0 0 0 0 0 0 0 0 0 0 0 0 0 0 0 0 0 0 0
0 0 0 0 0 0 25 26 57 58 61 62 29 30 0 0 0 0 0 0 0 0 0 0 0 0 25 26 57 58 61 62 29 30 0 0 0 0 0 0 0 0 0 0 0 0 25 26 57 58 61 62 29 30 0 0 0 0 0 0 0 0 0 0 0 0 0 0 0 0 0 0 0 0 0 0 0 0 0 0 0 0 0 0 0 0 0 0 89 90 121 122 122 122 122 123 123 124 91 92 0 0 0 0 624 752 618 619 620 621 618 619 620 621 618 619 620 621 626 0 0 0 0 0 0 0 0 0 0 0 0 265 622 265 0 0 0 0 0 0 0 0 0 0 0 0 0 0 0 0 0 0 0 0 0 0 0 0 0 0 0 0 0 0 0 0 0 0 0 0 0 0 0 0 0 0 0 0 0 0 0 0 0 0 0 0 0 0 0 0 0 0 0 0 0 0 0 0 0 0
0 0 0 0 25 26 57 58 0 0 0 0 61 62 29 30 0 0 0 0 0 0 0 0 25 26 57 58 0 0 0 0 61 62 29 30 0 0 0 0 0 0 0 0 25 26 57 58 0 0 0 0 61 62 29 30 0 0 0 0 0 0 0 0 0 0 0 0 0 0 0 0 0 0 0 0 0 0 0 0 0 0 0 0 0 0 89 90 121 122 122 122 122 122 122 122 122 123 123 124 91 92 0 0 656 784 650 651 652 653 650 651 652 653 650 651 652 653 658 0 0 0 0 0 0 0 0 0 0 0 0 265 654 265 0 0 0 0 0 0 0 0 0 0 0 0 0 0 0 0 0 0 0 0 0 0 0 0 0 0 0 0 0 0 0 0 0 0 0 0 0 0 0 0 0 0 0 0 0 0 0 0 0 0 0 0 0 0 0 0 0 0 0 0 0 0 0 0 0 0
0 0 25 26 57 58 0 0 0 0 0 0 0 0 61 62 29 30 0 0 0 0 25 26 57 58 0 0 0 0 0 0 0 0 61 62 29 30 0 0 0 0 25 26 57 58 0 0 0 0 0 0 0 0 61 62 29 30 0 0 0 0 0 0 167 168 0 0 167 168 0 0 0 0 0 167 168 0 0 0 0 0 167 168 89 90 121 122 122 122 122 122 122 122 122 122 122 122 122 123 123 124 91 92 688 752 682 683 684 685 682 683 684 685 682 683 684 685 690 0 0 0 0 0 0 0 0 0 0 0 0 265 686 265 0 0 0 0 0 0 0 0 0 0 0 0 0 0 0 0 0 0 0 0 0 0 0 0 0 0 429 429 429 429 429 429 429 429 429 429 429 429 429 429 429 429 429 429 429 429 429 429 429 429 0 0 0 0 0 0 0 0 0 0 0 0 0 0 0 0
25 26 57 58 0 0 0 0 0 0 0 0 0 0 0 0 61 62 29 30 25 26 57 58 0 0 0 0 0 0 0 0 0 0 0 0 61 62 29 30 25 26 57 58 0 0 0 0 0 0 0 0 0 0 0 0 61 62 29 30 0 0 0 0 199 200 0 0 199 200 0 0 0 0 0 199 200 0 0 0 0 0 199 200 121 122 122 122 122 122 122 122 122 122 122 122 122 123 122 122 122 123 123 124 199 784 714 715 716 717 714 715 716 717 714 715 716 717 506 507 265 506 507 265 506 507 265 506 507 265 506 507 718 506 507 508 506 507 508 452 453 452 453 452 453 452 453 452 452 453 452 453 452 453 452 453 452 453 452 453 522 523 522 523 522 523 522 523 522 523 522 523 522 523 522 523 522 523 522 523 522 523 522 523 0 0 0 0 0 0 0 0 0 0 0 0 0 0 0 0
57 58 0 0 0 0 0 0 0 0 0 0 0 0 0 0 0 0 61 62 57 58 0 0 0 0 0 0 0 0 0 0 0 0 0 0 0 0 61 62 57 58 0 0 0 0 0 0 0 0 0 0 0 0 0 0 0 0 61 62 325 326 327 328 329 330 326 327 328 329 330 326 327 328 329 330 326 327 328 329 330 326 327 328 329 330 326 327 328 329 330 326 327 328 329 330 326 327 328 329 330 326 327 328 329 330 326 327 750 751 750 751 750 751 750 751 750 751 538 539 540 538 539 540 538 539 540 538 539 540 538 539 540 538 539 540 538 539 540 484 485 484 485 484 485 484 485 484 484 485 484 485 484 485 484 485 484 485 484 485 746 747 748 749 746 747 748 749 746 747 748 749 746 747 748 749 746 747 748 749 746 747 748 749 0 0 0 0 0 0 0 0 0 0 0 0 0 0 0 0
