TILEMAP
200 20
16 16
tile.png---dat 
32 32
28 29 0 0 0 0 0 0 0 0 0 0 0 0 0 0 0 0 24 25 28 29 0 0 0 0 0 0 0 0 0 0 0 0 0 0 0 0 24 25 28 29 0 0 0 0 0 0 0 0 0 586 0 0 0 0 0 0 24 25 0 0 0 0 0 0 0 0 0 0 0 0 0 0 0 0 0 0 0 0 0 0 0 0 0 0 0 0 0 0 0 0 0 0 0 0 0 0 0 0 0 0 0 0 623 561 553 554 555 556 557 558 553 554 555 556 557 558 553 554 555 556 557 558 553 554 555 556 557 558 553 554 555 556 557 558 553 554 555 556 557 558 451 452 451 452 451 452 451 452 451 452 451 452 451 452 451 452 451 452 780 780 780 780 780 780 780 780 780 780 780 780 780 780 780 780 780 780 780 780 625 0 0 0 0 0 0 0 0 0 0 0 0 0 0 0 0 0 0 0 
60 61 28 29 0 0 0 0 0 0 0 0 0 0 0 0 24 25 56 57 60 61 28 29 0 0 0 0 0 0 0 0 0 0 0 0 24 25 56 57 60 61 28 29 0 0 0 0 0 0 0 586 0 0 0 0 24 25 56 57 0 0 0 0 0 0 0 0 0 0 0 0 0 0 0 0 0 0 0 0 0 0 0 0 0 0 0 0 0 0 0 0 0 0 0 0 0 0 0 0 0 0 0 0 655 593 585 586 587 588 589 590 585 586 587 588 589 590 585 586 587 588 589 590 585 586 587 588 589 590 585 586 587 588 589 590 585 586 587 588 589 590 483 484 483 484 483 484 483 484 483 484 483 484 483 484 483 484 483 484 780 780 780 780 780 780 780 780 780 780 780 780 780 780 780 780 780 780 780 780 657 0 0 0 0 0 0 0 0 0 0 0 0 0 0 0 0 0 0 0 
0 0 60 61 28 29 0 0 0 0 0 0 0 0 24 25 56 57 0 0 0 0 60 61 28 29 0 0 0 0 0 0 0 0 24 25 56 57 0 0 0 0 60 61 28 29 0 0 0 0 0 586 0 0 24 25 56 57 0 0 0 0 0 0 0 0 0 0 0 0 0 0 0 0 0 0 0 0 0 0 0 0 0 0 0 0 0 0 0 0 0 0 0 0 0 0 0 0 0 0 0 0 0 0 687 561 561 561 561 561 0 0 0 0 0 0 0 0 0 0 0 0 0 0 0 0 0 0 0 0 0 400 401 402 0 0 0 0 0 0 0 0 0 0 0 0 0 0 0 0 0 0 0 0 0 0 0 0 0 0 0 0 0 0 0 0 0 0 0 0 0 0 0 0 0 0 0 0 0 0 689 0 0 0 0 0 0 0 0 0 0 0 0 0 0 0 0 0 0 0 
0 0 0 0 60 61 28 29 0 0 0 0 24 25 56 57 0 0 0 0 0 0 0 0 60 61 28 29 0 0 0 0 24 25 56 57 0 0 0 0 0 0 0 0 60 61 28 29 0 0 0 586 24 25 56 57 0 0 0 0 0 0 0 0 0 0 0 0 0 0 0 0 0 0 0 0 0 0 0 0 0 0 0 160 161 162 161 163 0 0 0 0 0 0 0 0 0 0 0 0 0 0 0 0 623 593 593 593 593 593 0 0 0 0 0 0 0 0 0 0 0 0 0 0 0 0 0 0 0 0 0 400 401 402 0 0 0 0 0 0 0 0 0 0 0 0 0 0 0 0 0 0 0 0 0 0 0 0 0 0 0 0 0 0 0 0 0 0 0 0 0 0 0 0 0 0 0 0 0 0 625 0 0 0 0 0 0 0 0 0 0 0 0 0 0 0 0 0 0 0 
0 0 0 0 0 0 60 61 28 29 24 25 56 57 0 0 0 0 0 0 0 0 0 0 0 0 60 61 28 29 24 25 56 57 0 0 0 0 0 0 0 0 0 0 0 0 60 61 28 29 24 586 56 57 0 0 0 0 0 0 0 0 0 0 0 0 0 0 0 0 0 0 0 0 0 0 0 0 0 0 0 0 0 0 0 0 0 0 0 0 0 0 0 0 0 0 0 0 0 0 0 0 0 0 655 561 561 561 561 561 0 0 0 0 0 0 0 0 0 0 0 0 0 0 0 0 0 0 0 0 0 400 401 402 0 0 0 0 0 0 0 0 0 0 0 0 0 0 0 0 0 0 0 0 0 0 0 0 0 0 0 0 0 0 0 0 0 0 0 0 0 0 0 0 0 0 0 0 0 0 657 0 0 0 0 0 0 0 0 0 0 0 0 0 0 0 0 0 0 0 
0 0 0 0 0 0 0 0 60 61 56 57 0 0 0 0 0 0 0 0 0 0 0 0 0 0 0 0 60 61 56 57 0 0 0 0 0 0 0 0 0 0 0 0 0 0 0 0 60 61 56 586 0 0 0 0 0 0 0 0 0 0 0 0 0 0 0 0 0 0 0 0 0 0 0 0 0 0 0 0 0 0 0 0 0 0 0 0 0 0 0 0 0 0 0 0 0 0 0 0 0 0 0 0 687 593 593 593 593 593 0 0 0 0 0 0 0 0 0 0 0 0 0 0 0 0 0 0 0 0 0 400 401 402 0 0 0 0 0 0 0 0 0 0 0 0 0 0 0 0 0 0 0 0 0 0 0 0 0 0 0 0 0 0 0 0 0 0 0 0 0 0 0 0 0 0 0 0 0 0 689 0 0 0 0 0 0 0 0 0 0 0 0 0 0 0 0 0 0 0 
554 554 554 554 554 554 554 554 554 554 554 554 554 554 554 554 554 554 554 554 554 554 554 554 554 554 554 554 554 554 554 554 554 554 554 554 554 554 554 554 554 554 554 554 554 554 554 554 554 554 554 590 0 0 0 0 0 0 0 0 0 0 0 0 0 0 0 0 0 0 0 0 0 0 0 0 0 0 0 0 0 0 0 0 0 0 0 0 0 0 0 0 0 0 0 0 0 0 0 0 0 0 0 0 0 0 0 0 0 0 0 0 0 0 0 0 0 0 0 0 0 0 0 0 0 0 0 0 0 0 0 400 401 402 0 0 0 0 0 0 0 0 0 0 0 0 0 0 96 97 98 97 99 0 0 0 0 0 0 0 96 97 97 98 97 99 0 0 0 0 0 0 0 0 0 0 0 0 0 0 625 0 0 0 0 0 0 0 0 0 0 0 0 0 0 0 0 0 0 0 
53 332 332 332 332 332 332 332 332 332 332 332 332 332 332 332 332 332 332 332 332 332 332 332 332 332 332 332 332 332 332 332 332 332 332 332 332 332 332 332 332 332 332 332 332 332 332 332 332 332 332 0 0 0 0 0 0 0 0 0 0 0 0 0 0 0 0 0 0 0 0 0 0 0 0 0 0 0 0 0 0 0 0 0 0 0 0 0 0 0 0 0 0 0 0 0 0 0 0 0 0 0 0 0 0 0 0 0 0 0 0 0 0 0 0 0 0 0 0 0 0 0 0 0 0 0 0 0 0 0 0 400 401 402 0 0 0 0 0 0 0 0 0 0 0 0 0 0 0 0 0 0 0 0 0 0 0 0 0 0 0 0 0 0 0 0 0 0 0 0 0 0 0 0 0 0 0 0 0 0 657 0 0 0 0 0 0 0 0 0 0 0 0 0 0 0 0 0 0 0 
53 0 0 0 0 0 0 0 0 0 0 0 0 0 0 0 0 0 0 0 0 0 0 0 0 0 0 0 0 0 0 0 0 0 0 0 0 0 0 0 0 0 0 0 0 0 0 0 0 0 0 0 0 0 0 0 0 0 0 0 0 0 0 0 0 0 0 0 0 0 0 0 0 160 162 162 163 0 0 0 0 0 0 0 0 0 0 0 0 0 0 0 0 0 0 0 0 0 0 0 0 0 0 0 0 0 0 0 0 0 0 0 0 0 0 0 0 0 0 0 0 0 0 0 0 0 0 0 0 0 0 400 401 402 0 0 0 0 0 0 0 0 0 0 0 0 0 0 0 0 0 0 0 0 0 0 0 0 0 0 0 0 0 0 0 0 0 0 0 0 0 0 0 0 0 0 0 0 0 0 689 0 0 0 0 0 0 0 0 0 0 0 0 0 0 0 0 0 0 0 
53 0 0 0 0 0 0 0 0 0 0 0 0 0 0 0 0 0 0 0 0 0 0 0 0 0 0 0 0 0 0 0 0 0 0 0 0 0 0 0 0 0 0 0 0 0 0 0 0 0 0 0 0 0 0 0 0 0 0 0 0 0 0 0 0 0 0 0 0 0 0 0 0 0 0 0 0 0 0 0 0 0 0 0 0 0 0 0 0 0 0 0 0 0 0 0 0 0 0 0 0 0 0 0 623 160 162 162 162 161 162 162 162 161 162 162 162 162 163 0 0 0 0 0 0 32 33 33 33 33 34 400 401 402 0 0 0 0 0 0 0 0 0 0 0 0 0 0 0 0 0 0 0 0 0 0 0 0 0 0 0 0 0 0 0 0 0 0 0 0 0 0 0 0 0 0 0 0 0 0 625 0 0 0 0 0 0 0 0 0 0 0 0 0 0 0 0 0 0 0 
53 0 0 0 0 0 0 0 0 0 0 0 0 0 0 0 0 0 0 0 0 0 0 0 0 0 0 0 0 0 0 0 0 0 0 0 0 0 0 0 0 0 0 0 0 0 0 0 0 0 0 0 0 0 0 0 0 0 0 0 0 0 0 0 0 0 0 0 0 0 0 0 0 0 0 0 0 0 0 0 0 0 0 0 0 0 0 0 0 0 0 0 0 0 0 96 98 97 98 97 98 99 0 0 655 783 783 784 783 784 783 784 783 784 783 784 783 784 784 0 0 0 0 0 0 0 0 0 0 0 0 0 0 0 0 0 0 0 0 0 0 0 0 0 0 0 0 0 0 0 0 0 0 0 0 0 0 0 0 0 0 0 0 0 0 0 0 0 0 0 0 0 0 0 0 0 0 0 0 0 657 0 0 0 0 0 0 0 0 0 0 0 0 0 0 0 0 0 0 0 
53 0 0 0 0 0 0 0 0 0 0 0 0 0 0 0 0 0 0 0 0 0 0 0 0 0 0 0 0 0 0 0 0 0 0 0 0 0 0 0 0 0 0 0 0 0 0 0 0 0 0 0 0 0 0 0 0 0 0 0 0 0 0 0 0 0 0 0 0 0 0 0 0 0 0 0 0 0 0 0 0 0 0 0 0 0 0 0 0 0 0 0 0 0 0 0 0 0 0 0 0 0 0 0 687 751 617 618 619 620 617 618 619 620 617 618 619 620 689 0 0 0 0 0 0 0 0 0 0 0 0 0 0 0 0 0 0 0 0 0 0 0 0 0 0 0 0 0 0 0 0 0 0 0 0 0 0 0 0 0 0 0 0 0 0 0 0 0 0 0 0 0 0 0 0 0 0 0 0 0 689 0 0 0 0 0 0 0 0 0 0 0 0 0 0 0 0 0 0 0 
53 0 0 0 423 424 424 425 0 0 363 363 363 363 363 363 363 363 363 363 363 363 363 363 363 363 363 363 363 363 363 363 363 363 363 363 363 363 363 363 363 363 363 363 363 363 363 363 363 363 363 0 0 0 0 0 0 0 0 0 0 0 0 0 0 0 0 0 0 0 0 0 0 0 0 0 0 0 0 0 0 0 0 0 0 0 0 0 0 0 0 0 0 0 0 0 0 0 0 0 0 0 0 0 623 783 649 650 651 652 649 650 651 652 649 650 651 652 625 0 0 0 0 0 0 0 0 0 0 0 0 400 401 402 0 0 0 0 0 0 0 0 0 0 0 0 0 0 0 0 0 0 0 0 0 0 0 0 0 0 0 0 0 0 0 0 0 0 0 0 0 0 0 0 0 0 0 0 0 0 625 0 0 0 0 0 0 0 0 0 0 0 0 0 0 0 0 0 0 0 
554 554 554 554 554 554 554 554 554 554 554 554 554 554 554 554 554 554 554 554 554 554 554 554 554 554 554 554 554 554 554 554 554 554 554 554 554 554 554 554 554 554 554 554 554 554 554 554 554 554 554 558 0 132 133 0 0 0 0 0 0 0 0 0 0 0 0 0 0 0 0 0 0 0 0 0 0 0 0 0 0 0 0 0 0 0 0 0 0 0 0 0 88 89 90 91 0 0 0 0 0 0 0 0 655 751 681 0 683 684 681 682 683 684 681 682 683 684 657 0 0 0 0 0 0 0 0 0 0 0 0 400 401 402 0 0 0 0 0 0 0 0 0 0 0 0 0 0 0 0 0 0 0 0 0 0 0 0 0 0 0 0 0 0 0 0 0 0 0 0 0 0 0 0 0 0 0 0 0 0 657 0 0 0 0 0 0 0 0 0 0 0 0 0 0 0 0 0 0 0 
0 0 0 0 0 0 0 0 24 25 28 29 0 0 0 0 0 0 0 0 0 0 0 0 0 0 0 0 24 25 28 29 0 0 0 0 0 0 0 0 0 0 0 0 0 0 0 0 24 25 28 586 0 0 0 0 0 0 0 0 0 0 0 0 0 0 0 0 0 0 0 0 0 0 0 0 0 0 0 0 0 0 0 0 0 96 98 97 98 99 88 89 120 121 122 123 90 91 0 0 0 0 0 0 687 783 713 714 715 716 713 714 715 716 713 714 715 716 689 0 0 0 0 0 0 0 0 0 0 0 0 400 401 402 0 0 0 0 0 0 0 0 0 0 0 0 0 0 0 0 0 0 0 0 0 0 0 0 0 0 0 0 0 0 0 0 0 0 0 0 0 0 0 0 0 0 0 0 0 0 689 0 0 0 0 0 0 0 0 0 0 0 0 0 0 0 0 0 0 0 
0 0 0 0 0 0 24 25 56 57 60 61 28 29 0 0 0 0 0 0 0 0 0 0 0 0 24 25 56 57 60 61 28 29 0 0 0 0 0 0 0 0 0 0 0 0 24 25 56 57 60 586 28 29 0 0 0 0 0 0 128 129 129 130 129 130 129 130 129 129 130 129 130 129 129 130 129 129 129 130 129 129 129 131 0 0 0 0 88 89 120 121 46 46 46 46 122 123 90 91 0 0 0 0 623 751 617 618 619 620 617 618 619 620 617 618 619 620 625 0 0 0 0 0 0 0 0 0 0 0 0 400 401 402 0 0 0 0 0 0 0 0 0 0 0 0 0 0 65 66 66 66 67 0 0 0 0 0 0 0 65 66 66 66 66 67 0 0 0 0 0 0 0 0 0 0 0 0 0 0 0 0 0 0 0 0 0 0 0 0 0 0 0 0 0 0 0 0 0 0 
0 0 0 0 24 25 56 57 0 0 0 0 60 61 28 29 0 0 0 0 0 0 0 0 24 25 56 57 0 0 0 0 60 61 28 29 0 0 0 0 0 0 0 0 24 25 56 57 0 0 0 586 60 61 28 29 0 0 0 0 65 66 66 66 66 66 66 66 66 66 66 66 66 66 66 66 66 66 66 66 66 66 66 67 0 0 88 89 120 121 46 46 46 46 46 46 46 46 122 123 90 91 0 0 655 783 649 650 651 652 649 650 651 652 649 650 651 652 657 0 0 0 0 0 0 0 0 0 0 0 0 400 401 402 0 0 0 0 0 0 0 0 0 0 0 0 0 0 0 0 0 0 0 0 0 0 0 0 0 0 0 0 0 0 0 0 0 0 0 0 0 0 0 0 0 0 0 0 0 0 0 0 0 0 0 0 0 0 0 0 0 0 0 0 0 0 0 0 0 0 
0 0 24 25 56 57 0 0 0 0 0 0 0 0 60 61 28 29 0 0 0 0 24 25 56 57 0 0 0 0 0 0 0 0 60 61 28 29 0 0 0 0 24 25 56 57 0 0 0 0 0 586 0 0 60 61 28 29 0 0 176 177 178 139 140 0 0 0 0 0 0 139 140 0 0 0 0 0 0 139 140 176 177 178 88 89 120 121 46 46 46 46 46 46 46 46 46 46 46 46 122 123 90 91 687 751 681 682 683 684 681 682 683 684 681 682 683 684 689 65 66 66 66 66 66 66 66 66 66 66 67 400 401 402 0 0 0 0 0 0 0 0 0 0 0 0 0 0 0 0 0 0 0 0 0 0 0 0 0 0 0 0 0 0 0 0 0 0 0 0 0 0 0 0 0 0 0 0 0 0 0 0 0 0 0 0 0 0 0 0 0 0 0 0 0 0 0 0 0 0 
24 25 56 57 0 0 0 0 0 0 0 0 0 0 0 0 60 61 28 29 24 25 56 57 0 0 0 0 0 0 0 0 0 0 0 0 60 61 28 29 24 25 56 57 0 0 0 0 0 0 0 586 0 0 0 0 60 61 28 29 176 177 178 171 172 0 0 202 202 0 0 171 172 0 0 202 202 0 0 171 172 176 177 178 120 121 46 46 46 46 46 46 46 46 46 46 46 46 46 46 46 46 122 123 198 783 713 714 715 716 713 714 715 716 713 714 715 716 545 545 545 545 545 545 545 545 545 545 545 545 545 545 545 545 545 545 545 545 545 545 545 545 545 545 545 545 545 545 545 545 545 545 545 545 545 545 545 545 545 545 545 545 545 545 545 545 545 545 545 545 545 545 545 545 545 545 545 545 545 545 545 522 521 522 0 0 0 0 0 0 0 0 0 0 0 0 0 0 0 0 
56 57 0 0 0 0 0 0 0 0 0 0 0 0 0 0 0 0 60 61 56 57 0 0 0 0 0 0 0 0 0 0 0 0 0 0 0 0 60 61 56 57 0 0 0 0 0 0 0 0 0 586 0 0 0 0 0 0 60 61 294 294 294 294 294 294 294 294 294 294 294 294 294 294 294 294 294 294 294 294 294 294 294 294 294 294 294 294 294 294 294 294 294 294 294 294 294 294 294 294 294 294 294 294 545 545 545 545 545 545 545 545 545 545 545 545 545 545 545 545 545 545 545 545 545 545 545 545 545 545 545 545 545 545 545 545 545 545 545 545 545 545 545 545 545 545 545 545 545 545 545 545 545 545 545 545 545 545 545 545 545 545 545 545 545 545 545 545 545 545 545 545 545 545 545 545 545 545 545 545 545 746 747 748 0 0 0 0 0 0 0 0 0 0 0 0 0 0 0 0 

