TILEMAP
200 20        -- Size of tile map in tiles
16 16        -- Tile size & block size
textures/green_tile.png  -- Tilesheet
32 32         -- Number of tiles in tilesheet
0 0 0 0 0 0 0 0 0 0 562 563 564 565 566 567 562 563 564 565 566 567 562 563 564 565 566 567 562 563 564 565 566 567 562 563 564 565 566 567 562 563 564 565 566 567 562 563 564 565 566 567 562 563 564 565 566 567 562 563 564 565 566 567 562 563 564 565 566 567 562 563 564 565 566 567 562 563 564 565 566 567 562 563 564 565 566 567 562 563 564 565 566 567 562 563 564 565 566 567 562 563 564 565 566 567 562 563 564 565 566 567 562 563 564 565 566 567 562 563 564 565 566 567 562 563 564 565 566 567 562 563 564 565 566 567 562 563 564 565 566 567 562 563 564 565 566 567 562 563 564 565 566 567 562 563 564 565 566 567 562 563 564 565 566 567 562 563 564 565 566 567 562 563 564 565 566 567 562 563 564 565 566 567 562 563 564 565 566 0 0 0 0 0 0 0 0 0 0 0
0 0 0 0 0 0 0 0 0 0 594 595 596 597 598 599 594 595 596 597 598 599 594 595 596 597 598 599 594 595 596 597 598 599 594 595 596 597 598 599 594 595 596 597 598 599 594 595 596 597 598 599 594 595 596 597 598 599 594 595 596 597 598 599 594 595 596 597 598 599 594 595 596 597 598 599 594 595 596 597 598 599 594 595 596 597 598 599 594 595 596 597 598 599 594 595 596 597 598 599 594 595 596 597 598 599 594 595 596 597 598 599 594 595 596 597 598 599 594 595 596 597 598 599 594 595 596 597 598 599 594 595 596 597 598 599 594 595 596 597 598 599 594 595 596 597 598 599 594 595 596 597 598 599 594 595 596 597 598 599 594 595 596 597 598 599 594 595 596 597 598 599 594 595 596 597 598 599 594 595 596 597 598 599 594 595 596 597 598 0 0 0 0 0 0 0 0 0 0 0
0 0 0 0 0 0 0 0 0 0 0 0 0 0 0 0 0 0 0 0 0 0 0 0 0 0 0 0 0 0 0 0 0 0 0 0 0 0 0 0 0 0 0 0 0 0 0 0 0 138 138 0 0 0 0 0 0 0 0 0 0 0 0 0 0 0 0 0 0 0 0 0 0 0 0 0 0 0 0 0 0 0 0 0 0 0 0 0 0 0 0 0 0 0 0 945 946 945 946 945 946 945 946 945 946 945 946 945 946 945 946 945 946 945 946 945 946 945 946 945 946 945 946 945 946 945 946 945 946 945 946 945 946 945 946 945 946 945 946 945 946 945 946 945 946 945 946 945 946 945 946 945 946 945 946 945 946 945 946 945 946 945 946 945 946 945 946 945 946 945 946 945 946 945 946 945 946 945 946 945 946 945 946 945 946 945 946 945 946 0 0 0 0 0 0 0 0 0 0 0
0 0 0 0 0 0 0 0 0 0 138 138 138 138 138 138 138 138 138 138 138 138 138 138 138 138 138 138 138 138 138 138 138 138 138 138 138 138 138 138 138 138 138 138 138 138 138 138 138 138 138 0 39 0 0 0 0 0 0 363 0 0 0 0 0 0 39 0 0 0 0 0 363 0 0 0 0 39 0 0 0 363 0 0 0 39 0 0 0 363 0 0 0 39 0 977 978 977 978 977 978 977 978 977 978 977 978 977 978 977 978 977 978 977 978 977 978 977 978 977 978 977 978 977 978 977 978 977 978 977 978 977 978 977 978 977 978 977 978 977 978 977 978 977 978 977 978 977 978 977 978 977 978 977 978 977 978 977 978 977 978 977 978 977 978 977 978 977 978 977 978 977 978 977 978 977 978 977 978 977 978 977 978 977 978 977 978 977 978 0 0 0 0 0 0 0 0 0 0 0
0 0 0 0 0 0 0 0 0 0 138 0 0 0 0 0 0 0 0 0 0 0 0 0 0 0 0 0 0 0 0 0 0 0 0 0 0 0 0 0 0 0 0 0 0 0 0 0 0 0 0 805 806 807 0 39 39 0 805 806 807 0 39 39 0 805 806 807 39 39 0 805 806 807 39 39 805 806 807 0 805 806 807 0 805 806 807 0 805 806 807 0 805 806 807 0 0 0 0 0 0 0 0 0 0 0 0 0 0 0 0 0 0 0 0 0 0 0 0 0 0 0 0 0 0 0 0 0 0 0 0 0 0 0 0 0 0 0 0 0 0 0 0 0 0 0 0 0 0 0 0 0 0 0 0 0 0 0 0 0 0 0 0 0 0 0 0 0 0 0 0 0 0 0 0 0 0 0 0 0 0 0 0 0 0 0 0 0 0 0 0 0 0 0 0 0 0 0 0 0
0 0 0 0 0 0 0 0 0 0 138 0 0 0 0 138 138 138 138 138 138 138 138 138 138 138 138 138 138 0 0 0 0 0 0 0 0 0 0 0 0 0 0 0 0 0 0 0 0 0 0 837 200 839 0 8 8 0 837 200 839 0 8 8 0 837 200 839 8 8 0 837 200 839 8 8 837 200 839 0 837 200 839 0 837 200 839 0 837 200 839 0 837 200 839 882 883 882 883 882 883 882 883 882 883 882 883 882 883 882 883 882 883 882 883 882 883 882 883 882 883 882 883 882 883 882 883 882 883 882 883 882 883 882 883 882 883 882 883 882 883 882 883 882 883 882 883 882 883 882 883 882 883 882 883 882 883 882 883 882 883 882 883 882 883 882 883 882 883 882 883 882 883 882 883 882 883 882 883 882 883 882 883 882 883 882 883 882 883 0 0 0 0 0 0 0 0 0 0 0
0 0 0 0 0 0 0 0 0 0 138 0 0 0 0 138 0 0 0 0 0 0 0 0 0 0 0 0 138 0 0 0 0 0 0 0 0 0 0 138 138 0 0 0 0 0 0 0 0 0 0 869 870 871 0 0 0 0 869 870 871 0 0 0 0 869 870 871 0 0 0 869 870 871 0 0 869 870 871 0 869 870 871 0 869 870 871 0 869 870 871 0 869 870 871 914 915 914 915 914 915 914 915 914 915 914 915 914 915 914 915 914 915 914 915 914 915 914 915 914 915 914 915 914 915 914 915 914 915 914 915 914 915 914 915 914 915 914 915 914 915 914 915 914 915 914 915 914 915 914 915 914 915 914 915 914 915 914 915 914 915 914 915 914 915 914 915 914 915 914 915 914 915 914 915 914 915 914 915 914 915 914 915 914 915 914 915 914 915 0 0 0 0 0 0 0 0 0 0 0
0 0 0 0 0 0 0 0 0 0 138 0 0 0 0 138 0 0 0 0 0 0 0 0 0 0 0 0 138 0 0 0 0 0 0 0 0 0 200 138 138 0 0 0 0 0 0 0 0 0 0 0 8 0 0 0 0 0 0 332 0 0 0 0 0 0 8 0 0 0 0 0 332 0 0 0 0 8 0 0 0 332 0 0 0 8 0 0 0 332 0 0 0 0 0 0 721 721 721 721 721 721 721 721 721 721 721 721 721 721 721 721 721 721 721 721 721 721 721 721 721 721 721 721 721 721 721 721 721 721 721 721 721 721 721 721 721 721 721 721 721 721 721 721 721 721 721 721 721 721 721 721 721 721 721 721 721 721 721 721 721 721 721 721 721 721 721 721 721 721 721 721 721 721 721 721 721 721 721 721 721 721 721 721 721 721 721 721 721 0 0 0 0 0 0 0 0 0 0 0
0 0 0 0 0 0 0 0 0 0 138 0 0 0 0 0 0 0 0 0 0 0 0 0 0 0 0 0 0 0 0 0 0 0 0 0 0 200 138 138 138 0 0 0 0 0 0 0 0 0 0 0 0 0 0 0 0 0 0 0 0 0 0 0 0 0 0 0 0 0 0 0 0 0 0 0 0 0 0 0 0 0 0 0 0 0 0 0 0 0 0 0 0 0 0 0 0 0 0 0 0 0 0 0 0 0 0 0 0 0 0 0 0 0 0 0 0 0 0 0 0 0 0 0 0 0 0 0 0 0 0 0 0 0 0 0 0 0 0 0 0 0 0 0 0 0 0 0 0 0 0 0 0 0 0 0 0 0 0 0 0 0 0 0 0 0 0 0 0 0 0 0 0 0 0 0 0 0 0 0 0 0 0 0 0 0 0 0 0 0 0 0 0 0 0 0 0 0 0 0
0 0 0 0 0 0 0 0 0 0 0 0 0 0 0 0 0 0 0 0 0 0 0 0 0 0 0 0 0 0 0 0 0 0 0 0 200 138 138 138 138 0 0 0 0 0 0 0 0 0 0 0 0 0 0 0 0 0 0 0 0 0 0 0 0 0 0 0 0 0 0 0 0 0 0 0 0 0 0 0 0 0 0 0 0 0 0 0 0 0 0 0 0 0 0 0 0 0 0 0 0 0 0 0 0 0 0 0 0 0 0 0 0 0 0 0 0 0 0 0 0 0 0 0 0 0 0 0 0 0 0 0 0 0 0 0 0 0 0 0 0 0 0 0 0 0 0 0 0 0 0 0 0 0 0 0 0 0 0 0 0 0 0 0 0 0 0 0 0 0 0 0 0 0 0 0 0 0 0 0 0 0 0 0 0 0 0 0 0 0 0 0 0 0 0 0 0 0 0 0
0 0 0 0 0 0 0 0 0 0 0 0 0 0 0 0 138 138 138 138 138 138 138 138 138 138 138 138 138 0 0 0 0 0 0 200 138 138 0 138 138 0 0 0 0 0 0 0 0 0 0 0 39 0 0 0 0 0 0 363 0 0 0 0 0 0 39 0 0 0 0 0 363 0 0 0 0 39 0 0 0 363 0 0 0 39 0 0 0 363 0 0 0 39 0 0 0 0 0 0 0 0 0 0 0 0 0 0 0 0 0 0 0 0 0 0 0 0 0 0 0 0 0 0 0 0 0 0 0 0 0 0 0 0 0 0 0 0 0 0 0 0 0 0 0 0 0 0 0 0 0 0 0 0 0 0 0 0 0 0 0 0 0 0 0 0 0 0 0 0 0 0 0 0 0 0 0 0 0 0 0 0 0 0 0 0 0 0 0 0 0 0 0 0 0 0 0 0 0 0
0 0 0 0 0 0 0 0 0 0 138 0 0 0 0 0 138 138 138 138 138 138 138 138 138 138 138 138 138 0 0 0 0 0 200 138 138 0 0 138 138 0 0 0 0 0 0 0 0 0 0 805 806 807 0 0 0 0 805 806 807 0 0 0 0 805 806 807 0 0 0 805 806 807 0 0 805 806 807 0 805 806 807 0 805 806 807 0 805 806 807 0 805 806 807 0 721 721 721 721 721 721 721 721 721 721 721 721 721 721 721 721 721 721 721 721 721 721 721 721 721 721 721 721 721 721 721 721 721 721 721 721 721 721 721 721 721 721 721 721 721 721 721 721 721 721 721 721 721 721 721 721 721 721 721 721 721 721 721 721 721 721 721 721 721 721 721 721 721 721 721 721 721 721 721 721 721 721 721 721 721 721 721 721 721 721 721 721 721 0 0 0 0 0 0 0 0 0 0 0
0 0 0 0 0 0 0 0 0 0 138 0 0 0 0 0 0 0 0 0 0 0 0 0 0 0 0 0 0 0 0 0 0 200 138 138 0 0 0 138 138 0 0 0 0 0 0 0 0 0 0 837 200 839 0 39 39 0 837 200 839 0 39 39 0 837 200 839 39 39 0 837 200 839 39 39 837 200 839 0 837 200 839 0 837 200 839 0 837 200 839 0 837 200 839 882 883 882 883 882 883 882 883 882 883 882 883 882 883 882 883 882 883 882 883 882 883 882 883 882 883 882 883 882 883 882 883 882 883 882 883 882 883 882 883 882 883 882 883 882 883 882 883 882 883 882 883 882 883 882 883 882 883 882 883 882 883 882 883 882 883 882 883 882 883 882 883 882 883 882 883 882 883 882 883 882 883 882 883 882 883 882 883 882 883 882 883 882 883 0 0 0 0 0 0 0 0 0 0 0
0 0 0 0 0 0 0 0 0 0 138 0 0 0 0 0 0 0 0 0 0 0 0 0 0 0 0 0 0 0 0 0 200 138 138 0 0 0 0 138 138 0 0 0 0 0 0 0 0 0 0 869 870 871 0 8 8 0 869 870 871 0 8 8 0 869 870 871 8 8 0 869 870 871 8 8 869 870 871 0 869 870 871 0 869 870 871 0 869 870 871 0 869 870 871 914 915 914 915 914 915 914 915 914 915 914 915 914 915 914 915 914 915 914 915 914 915 914 915 914 915 914 915 914 915 914 915 914 915 914 915 914 915 914 915 914 915 914 915 914 915 914 915 914 915 914 915 914 915 914 915 914 915 914 915 914 915 914 915 914 915 914 915 914 915 914 915 914 915 914 915 914 915 914 915 914 915 914 915 914 915 914 915 914 915 914 915 914 915 0 0 0 0 0 0 0 0 0 0 0
0 0 0 0 0 0 0 0 0 0 138 138 138 138 138 138 138 138 138 138 138 138 138 138 138 138 138 138 138 138 138 138 138 138 138 138 138 138 138 138 138 138 138 138 138 138 138 138 138 138 138 0 8 0 0 0 0 0 0 332 0 0 0 0 0 0 8 0 0 0 0 0 332 0 0 0 0 8 0 0 0 332 0 0 0 8 0 0 0 332 0 0 0 8 0 0 0 0 0 0 0 0 0 0 0 0 0 0 0 0 0 0 0 0 0 0 0 0 0 0 0 0 0 0 0 0 0 0 0 0 0 0 0 0 0 0 0 0 0 0 0 0 0 0 0 0 0 0 0 0 0 0 0 0 0 0 0 0 0 0 0 0 0 0 0 0 0 0 0 0 0 0 0 0 0 0 0 0 0 0 0 0 0 0 0 0 0 0 0 0 0 0 0 0 0 0 0 0 0 0
0 0 0 0 0 0 0 0 0 0 139 140 139 140 139 140 139 140 139 140 0 0 0 0 0 0 0 0 0 0 0 0 0 0 0 0 0 0 0 0 0 0 0 0 0 0 0 0 0 138 138 0 0 0 0 0 0 0 0 0 0 0 0 0 0 0 0 0 0 0 0 0 0 0 0 0 0 0 0 0 0 0 0 0 0 0 0 0 0 0 0 0 0 0 0 0 0 0 0 0 0 0 0 0 0 0 0 0 0 0 0 0 0 0 0 0 0 0 0 0 0 0 0 0 0 0 0 0 0 0 0 0 0 0 0 0 0 0 0 0 0 0 0 0 0 0 0 0 0 0 0 0 0 0 0 0 0 0 0 0 0 0 0 0 0 0 0 0 0 0 0 0 0 0 0 0 0 0 0 0 0 0 0 0 0 0 0 0 0 0 0 0 0 0 0 0 0 0 0 0
0 0 0 0 0 0 0 0 0 0 171 172 171 172 171 172 171 172 171 172 0 0 0 0 0 0 0 0 0 0 0 0 0 0 0 0 0 0 0 0 0 0 0 0 0 0 0 0 0 138 138 943 944 943 944 943 944 943 944 943 944 943 944 943 944 943 944 943 944 943 944 943 944 943 944 943 944 943 944 943 944 943 944 943 944 943 944 943 944 943 944 943 944 943 944 945 946 945 946 945 946 945 946 945 946 945 946 945 946 945 946 945 946 945 946 945 946 945 946 945 946 945 946 945 946 945 946 945 946 945 946 945 946 945 946 945 946 945 946 945 946 945 946 945 946 945 946 945 946 945 946 945 946 945 946 945 946 945 946 945 946 945 946 945 946 945 946 945 946 945 946 945 946 945 946 945 946 945 946 945 946 945 946 945 946 945 946 945 946 0 0 0 0 0 0 0 0 0 0 0
0 0 0 0 0 0 0 0 0 0 0 0 0 0 0 0 0 0 0 0 0 0 0 0 0 0 0 0 0 0 0 0 0 0 0 0 0 0 0 0 0 0 0 0 0 0 0 0 0 138 138 975 976 975 976 975 976 975 976 975 976 975 976 975 976 975 976 975 976 975 976 975 976 975 976 975 976 975 976 975 976 975 976 975 976 975 976 975 976 975 976 975 976 975 976 977 978 977 978 977 978 977 978 977 978 977 978 977 978 977 978 977 978 977 978 977 978 977 978 977 978 977 978 977 978 977 978 977 978 977 978 977 978 977 978 977 978 977 978 977 978 977 978 977 978 977 978 977 978 977 978 977 978 977 978 977 978 977 978 977 978 977 978 977 978 977 978 977 978 977 978 977 978 977 978 977 978 977 978 977 978 977 978 977 978 977 978 977 978 0 0 0 0 0 0 0 0 0 0 0
0 0 0 0 0 0 0 0 0 0 760 761 760 761 760 761 760 761 760 761 760 761 760 761 760 761 760 761 760 761 760 761 760 761 760 761 760 761 760 761 760 761 760 761 760 761 760 761 760 761 760 761 760 761 760 761 760 761 760 761 760 761 760 761 760 761 760 761 760 761 760 761 760 761 760 761 760 761 760 761 760 761 760 761 760 761 760 761 760 761 760 761 760 761 760 761 760 761 760 761 760 761 760 761 760 761 760 761 760 761 760 761 760 761 760 761 760 761 760 761 760 761 760 761 760 761 760 761 760 761 760 761 760 761 760 761 760 761 760 761 760 761 760 761 760 761 760 761 760 761 760 761 760 761 760 761 760 761 760 761 760 761 760 761 760 761 760 761 760 761 760 761 760 761 760 761 760 761 760 761 760 761 760 761 760 761 760 761 760 0 0 0 0 0 0 0 0 0 0 0
0 0 0 0 0 0 0 0 0 0 792 793 792 793 792 793 792 793 792 793 792 793 792 793 792 793 792 793 792 793 792 793 792 793 792 793 792 793 792 793 792 793 792 793 792 793 792 793 792 793 792 793 792 793 792 793 792 793 792 793 792 793 792 793 792 793 792 793 792 793 792 793 792 793 792 793 792 793 792 793 792 793 792 793 792 793 792 793 792 793 792 793 792 793 792 793 792 793 792 793 792 793 792 793 792 793 792 793 792 793 792 793 792 793 792 793 792 793 792 793 792 793 792 793 792 793 792 793 792 793 792 793 792 793 792 793 792 793 792 793 792 793 792 793 792 793 792 793 792 793 792 793 792 793 792 793 792 793 792 793 792 793 792 793 792 793 792 793 792 793 792 793 792 793 792 793 792 793 792 793 792 793 792 793 792 793 792 793 792 0 0 0 0 0 0 0 0 0 0 0

