TILEMAP
200 20        -- Size of tile map in tiles
16 16       -- Tile size & block size
textures/green_tile.png  -- Tilesheet
32 32         -- Number of tiles in tilesheet
0 0 0 0 0 0 0 0 0 0 824 825 826 824 825 826 824 825 826 632 632 824 825 826 824 825 826 824 825 826 824 825 826 824 825 826 824 825 826 824 825 826 824 825 826 824 825 826 824 825 826 824 825 826 824 825 826 824 825 826 824 825 826 824 825 826 824 825 826 824 825 826 824 825 826 824 825 826 824 825 826 824 825 826 824 825 826 824 825 826 824 825 826 824 825 826 824 825 826 824 825 826 824 825 826 824 825 826 824 825 826 824 825 826 824 825 826 824 825 826 824 825 826 824 825 826 824 825 826 824 825 826 824 825 826 824 825 826 824 825 826 824 825 826 824 825 826 824 825 826 824 825 826 824 825 826 824 825 826 824 825 826 824 825 826 824 825 826 824 825 826 824 825 826 824 825 826 0 0 0 0 0 0 183 183 183 183 183 183 183 0 0 0 0 0 0 0 0 0 0
0 0 0 0 0 0 0 0 0 0 856 265 858 856 265 858 856 265 858 664 664 856 265 858 856 265 858 856 265 858 856 265 858 856 265 858 856 265 858 856 265 858 856 265 858 856 265 858 856 265 858 856 265 858 856 265 858 856 265 858 856 265 858 856 265 858 856 265 858 856 265 858 856 265 858 856 265 858 856 265 858 856 265 858 856 265 858 856 265 858 856 265 858 856 265 858 856 265 858 856 265 858 856 265 858 856 265 858 856 265 858 856 265 858 856 265 858 856 265 858 856 265 858 856 265 858 856 265 858 856 265 858 856 265 858 856 265 858 856 265 858 856 265 858 856 265 858 856 265 858 856 265 858 856 265 858 856 265 858 856 265 858 856 265 858 856 265 858 856 265 858 856 265 858 856 265 858 0 0 0 0 0 0 183 183 183 183 183 183 183 0 0 0 0 0 0 0 0 0 0
0 0 0 0 0 0 0 0 0 0 888 889 890 888 889 890 888 889 890 696 696 888 889 890 888 889 890 888 889 890 888 889 890 888 889 890 888 889 890 888 889 890 888 889 890 888 889 890 888 889 890 888 889 890 888 889 890 888 889 890 888 889 890 888 889 890 888 889 890 888 889 890 888 889 890 888 889 890 888 889 890 888 889 890 888 889 890 888 889 890 888 889 890 888 889 890 888 889 890 888 889 890 888 889 890 888 889 890 888 889 890 888 889 890 888 889 890 888 889 890 888 889 890 888 889 890 888 889 890 888 889 890 888 889 890 888 889 890 888 889 890 888 889 890 888 889 890 888 889 890 888 889 890 888 889 890 888 889 890 888 889 890 888 889 890 888 889 890 888 889 890 888 889 890 888 889 890 0 0 0 0 0 0 183 183 183 183 183 183 183 0 0 0 0 0 0 0 0 0 0
0 0 0 0 0 0 0 0 0 0 265 265 265 265 265 265 265 265 265 728 728 265 265 265 265 265 265 265 265 265 265 265 265 265 265 265 265 265 265 265 265 265 265 265 265 265 265 265 265 265 265 265 265 265 265 265 265 265 265 265 265 265 265 265 265 265 265 265 265 265 265 265 265 265 265 265 265 265 265 265 265 265 265 265 265 265 265 265 265 265 265 265 265 265 265 265 265 265 265 265 265 265 265 265 265 265 265 265 265 265 265 265 265 265 265 265 265 265 265 265 265 265 265 265 265 265 265 265 265 265 265 265 265 265 265 265 265 265 265 265 265 265 265 265 265 265 265 265 265 265 265 265 265 265 265 265 265 265 265 265 265 265 265 265 265 265 265 265 265 265 265 265 265 265 265 265 265 0 0 0 0 0 0 183 183 183 183 183 183 183 0 0 0 0 0 0 0 0 0 0
0 0 0 0 0 0 0 0 0 0 0 0 0 0 0 0 0 0 397 632 632 397 0 0 0 0 0 0 0 0 0 0 0 0 0 0 0 0 0 0 0 0 0 0 0 0 0 0 0 0 0 0 0 0 0 0 0 0 0 0 0 0 0 0 0 0 0 0 0 0 0 0 0 0 0 0 0 0 0 790 627 790 790 630 627 790 790 630 627 790 790 630 627 790 790 630 627 790 790 630 0 0 0 0 0 0 0 0 0 0 0 0 0 0 0 0 0 0 0 0 0 0 0 0 0 0 0 0 0 0 0 0 0 0 0 0 0 0 0 0 0 0 0 0 0 0 0 0 0 0 0 0 0 0 0 0 0 0 0 0 0 0 0 0 0 0 0 0 0 0 0 0 0 0 0 0 0 0 0 0 0 0 0 183 183 183 183 183 183 183 0 0 0 0 0 0 0 0 0 0
0 0 0 0 0 0 0 0 0 0 0 0 0 0 0 0 0 0 397 664 664 397 0 0 0 0 0 0 0 0 0 0 0 0 0 0 0 0 0 0 0 0 0 0 0 0 0 0 0 0 0 0 0 0 0 0 0 0 0 0 0 0 0 0 0 0 0 0 0 0 0 0 0 0 0 0 0 0 0 790 659 660 661 662 659 660 661 662 659 660 661 662 659 660 661 662 659 660 661 662 0 0 0 0 0 0 0 0 0 0 0 0 0 0 0 0 0 0 0 0 0 0 0 0 0 0 0 0 0 0 0 0 0 0 0 0 0 0 0 0 0 0 0 0 0 0 0 0 0 0 0 0 0 0 0 0 0 0 0 0 0 25 26 29 30 0 0 0 0 25 26 27 28 0 0 0 0 0 0 0 0 31 32 183 183 183 183 183 183 183 0 0 0 0 0 0 0 0 0 0
0 0 0 0 0 0 0 0 0 0 0 0 0 0 0 0 0 0 397 696 696 397 0 489 489 489 489 489 489 489 489 489 0 0 0 0 0 0 0 0 0 0 0 0 0 0 0 0 0 0 0 0 0 0 0 0 0 0 0 0 0 0 0 0 0 0 0 0 0 0 0 0 0 0 0 0 0 0 0 790 691 692 693 694 691 692 693 694 691 692 693 694 691 692 693 694 691 692 693 694 0 0 0 0 0 0 0 0 0 0 0 0 0 0 0 0 0 0 0 0 0 0 0 0 0 0 0 0 0 0 0 0 0 0 0 0 0 0 0 0 0 0 0 0 0 0 0 0 0 0 0 0 0 0 0 0 0 0 0 25 26 57 58 61 62 29 30 25 26 57 58 59 60 27 28 0 0 0 0 31 32 63 64 0 0 0 0 0 0 0 0 0 0 0 0 0 0 0 0 0
0 0 0 0 0 0 0 0 0 0 0 0 0 0 0 0 0 0 397 728 728 397 0 0 0 0 0 0 0 0 0 489 0 0 489 489 489 489 489 489 489 489 489 489 0 0 0 0 285 286 287 285 286 287 285 286 287 285 286 287 285 286 287 285 286 287 285 286 287 285 286 287 285 286 287 0 0 0 0 790 723 790 790 726 723 790 790 726 723 790 790 726 723 790 790 726 723 790 790 726 389 390 391 389 390 391 389 390 389 390 391 389 390 391 389 390 391 389 390 391 746 747 748 749 746 747 748 746 747 748 749 746 747 748 749 746 747 748 749 746 747 748 749 746 747 748 749 746 747 748 749 746 747 748 749 746 747 748 749 57 58 0 0 0 0 61 62 57 58 0 0 0 0 59 60 27 28 31 32 63 64 0 0 0 0 0 0 0 0 0 0 0 0 0 0 0 0 0 0 0
0 0 0 0 0 0 0 0 0 0 0 0 0 0 0 0 0 0 429 429 429 429 0 0 0 0 0 0 0 0 0 489 0 0 0 0 0 0 0 0 0 0 0 0 0 0 0 0 317 521 319 317 521 319 317 521 319 317 521 319 317 521 319 317 521 319 317 521 319 317 521 319 317 521 319 0 0 0 0 0 0 0 0 0 0 0 0 0 0 0 0 0 0 0 0 0 0 0 0 0 0 0 0 0 0 0 0 0 0 0 0 0 0 0 0 0 0 0 0 0 0 0 0 0 0 0 0 0 0 0 0 0 0 0 0 0 0 0 0 0 0 0 0 0 0 0 0 0 0 0 0 0 0 0 0 0 0 0 0 0 0 0 0 0 0 0 0 0 0 0 0 0 0 0 0 59 60 63 64 0 0 0 0 0 0 0 0 0 0 0 0 0 0 0 0 0 0 0 0 0
0 0 0 0 0 0 0 0 0 0 0 0 0 0 0 0 0 0 0 0 0 0 0 0 0 0 0 0 0 0 0 489 0 0 0 0 0 0 0 0 0 0 0 0 0 0 0 0 349 350 351 349 350 351 349 350 351 349 350 351 349 350 351 349 350 351 349 350 351 349 350 351 349 350 351 0 0 0 0 0 0 0 0 0 0 0 0 0 0 0 0 0 0 0 0 0 0 0 0 0 0 0 0 0 0 40 40 40 40 40 40 40 40 40 40 0 0 0 0 0 0 0 0 40 40 40 40 40 40 40 40 0 0 0 0 0 0 0 0 0 0 0 0 0 0 0 0 0 0 0 0 0 0 0 0 0 0 0 0 0 0 0 0 0 0 0 0 0 0 0 0 0 0 0 0 0 0 0 0 0 0 0 0 0 0 0 0 0 0 0 0 0 0 0 0 0 0 0 0 0
0 0 0 0 0 0 0 0 0 0 0 0 0 0 0 0 0 0 0 0 0 0 0 0 0 0 0 0 0 0 0 0 0 489 489 489 489 489 489 489 489 489 489 489 0 0 0 0 0 0 0 0 0 0 0 0 0 0 0 0 0 0 0 0 0 0 0 0 0 0 0 0 0 0 0 0 0 0 0 790 627 790 790 630 627 790 790 630 627 790 790 630 627 790 790 630 627 790 790 630 0 0 0 0 41 750 751 750 751 750 751 750 751 750 751 8 0 0 0 0 0 0 41 750 751 750 751 750 751 750 751 8 0 0 0 0 40 40 0 0 0 41 750 751 750 751 750 751 750 751 750 751 8 0 0 0 0 0 0 0 0 0 0 0 0 0 0 0 0 0 0 0 0 0 0 0 0 0 0 0 0 0 0 0 0 0 0 0 0 0 0 0 0 0 0 0 0 0 0 0
0 0 0 0 0 0 0 0 0 0 0 0 0 0 0 0 0 0 429 429 429 429 0 489 0 0 0 0 0 0 0 0 0 0 0 0 0 0 0 0 0 0 0 0 0 0 0 0 0 0 0 0 0 0 0 0 0 0 0 0 0 0 0 0 0 0 0 0 0 0 0 0 0 0 0 0 0 0 0 790 659 660 661 662 659 660 661 662 659 660 661 662 659 660 661 662 659 660 661 662 0 0 0 0 41 782 783 782 783 782 783 782 783 782 783 8 0 0 0 0 0 0 41 782 783 782 783 782 783 782 783 8 0 0 0 0 9 9 0 0 0 41 782 783 782 783 782 783 782 783 782 783 8 0 0 0 0 0 0 0 0 0 25 26 29 30 0 0 0 0 0 0 0 0 31 32 27 28 0 0 0 0 0 0 0 0 0 0 0 0 0 0 0 0 0 0 0 0 0 0
0 0 0 0 0 0 0 0 0 0 0 0 0 0 0 0 0 0 397 632 632 397 0 489 0 0 0 0 0 0 0 0 0 0 0 0 0 0 0 0 0 0 0 0 364 364 364 364 364 364 364 364 364 364 364 364 364 364 364 364 364 364 364 364 364 364 364 364 364 364 364 364 364 364 364 364 364 364 364 364 691 692 693 694 691 692 693 694 691 692 693 694 691 692 693 694 691 692 693 694 0 0 0 0 0 0 0 0 0 0 0 0 0 0 0 0 0 0 0 0 0 0 0 0 0 0 0 0 0 0 0 0 0 0 0 0 0 0 0 0 0 0 9 9 9 9 9 9 9 9 9 9 0 0 0 0 0 0 0 0 25 26 57 58 61 62 29 30 0 0 0 0 31 32 63 64 59 60 27 28 0 0 0 0 0 0 0 0 0 0 0 0 0 0 0 0 0 0 0 0
0 0 0 0 0 0 0 0 0 0 0 0 0 0 0 0 0 0 397 664 664 397 0 489 489 489 489 489 489 489 489 489 0 0 0 489 489 489 489 489 489 489 489 489 424 425 426 424 425 426 424 425 426 424 425 426 424 425 426 424 425 426 424 425 426 424 425 426 424 425 426 424 425 426 424 425 426 424 425 426 723 790 790 726 723 790 790 726 723 790 790 726 723 790 790 726 723 790 790 726 429 429 429 429 429 429 429 429 429 429 429 429 429 429 429 429 429 429 0 0 0 0 0 0 0 0 0 0 0 0 0 0 0 0 0 0 0 0 0 0 0 0 0 0 0 0 0 0 0 0 0 0 0 0 0 0 0 0 25 26 57 58 0 0 0 0 61 62 29 30 31 32 63 64 0 0 0 0 59 60 27 28 0 0 0 0 0 0 0 0 0 0 0 0 0 0 0 0 0 0
0 0 0 0 0 0 0 0 0 0 0 0 0 0 0 0 0 0 397 696 696 397 0 0 0 0 0 0 0 0 0 0 0 0 0 489 0 0 0 0 0 0 0 0 0 0 0 0 0 0 0 0 0 0 0 0 0 0 0 0 0 0 0 0 0 0 0 0 0 0 0 0 0 0 0 0 0 0 0 0 0 0 0 0 0 0 0 0 0 0 0 0 0 0 0 0 0 0 0 0 490 491 492 524 525 524 525 524 525 524 525 524 525 524 525 524 525 525 746 747 748 749 746 747 748 749 746 747 748 749 746 747 748 749 746 747 748 749 746 747 748 749 746 747 748 749 746 747 748 749 746 747 748 749 746 747 748 749 57 58 0 0 0 0 0 0 0 0 61 62 63 64 0 0 0 0 0 0 0 0 59 60 27 28 0 0 0 0 0 0 0 0 0 0 0 0 0 0 0 0
0 0 0 0 0 0 0 0 0 0 0 0 0 0 0 0 0 0 397 728 728 397 0 0 0 0 0 0 0 0 0 0 0 0 0 0 0 0 0 0 0 0 0 0 0 0 0 0 0 0 0 0 0 0 0 0 0 0 0 0 0 0 0 0 0 0 0 0 0 0 0 0 0 0 0 0 0 0 0 0 0 0 0 0 0 0 0 0 0 0 0 0 0 0 0 0 0 0 0 0 0 0 0 0 0 0 0 0 0 0 0 0 0 0 0 0 0 0 0 0 0 0 0 0 0 0 0 0 0 0 0 0 0 0 0 0 0 0 0 0 0 0 0 0 0 0 0 0 0 0 0 0 0 0 0 0 0 0 0 0 0 0 0 0 0 0 0 0 0 0 0 0 0 0 0 0 0 0 0 0 0 0 59 60 183 183 183 183 183 183 0 0 0 0 0 0 0 0 0 0
0 0 0 0 0 0 0 0 0 0 265 265 265 265 265 265 265 265 265 632 632 265 265 265 265 265 265 265 265 265 265 265 265 265 265 265 265 265 265 265 265 265 265 265 265 265 265 265 265 265 265 265 265 265 265 265 265 265 265 265 265 265 265 265 265 265 265 265 265 265 265 265 265 265 265 265 265 265 265 265 265 265 265 265 265 265 265 265 265 265 265 265 265 265 265 265 265 265 265 265 265 265 265 265 265 265 265 265 265 265 265 265 265 265 265 265 265 265 265 265 265 265 265 265 265 265 265 265 265 265 265 265 265 265 265 265 265 265 265 265 265 265 265 265 265 265 265 265 265 265 265 265 265 265 265 265 265 265 265 265 265 265 265 265 265 265 265 265 265 265 265 265 265 265 265 265 265 0 0 0 0 0 0 0 183 183 183 183 183 183 0 0 0 0 0 0 0 0 0 0
0 0 0 0 0 0 0 0 0 0 824 825 826 824 825 826 824 825 826 664 664 824 825 826 824 825 826 824 825 826 824 825 826 824 825 826 824 825 826 824 825 826 824 825 826 824 825 826 824 825 826 824 825 826 824 825 826 824 825 826 824 825 826 824 825 826 824 825 826 824 825 826 824 825 826 824 825 826 824 825 826 824 825 826 824 825 826 824 825 826 824 825 826 824 825 826 824 825 826 824 825 826 824 825 826 824 825 826 824 825 826 824 825 826 824 825 826 824 825 826 824 825 826 824 825 826 824 825 826 824 825 826 824 825 826 824 825 826 824 825 826 824 825 826 824 825 826 824 825 826 824 825 826 824 825 826 824 825 826 824 825 826 824 825 826 824 825 826 824 825 826 824 825 826 824 825 826 0 0 0 0 0 0 0 183 183 183 183 183 183 0 0 0 0 0 0 0 0 0 0
0 0 0 0 0 0 0 0 0 0 856 265 858 856 265 858 856 265 858 696 696 856 265 858 856 265 858 856 265 858 856 265 858 856 265 858 856 265 858 856 265 858 856 265 858 856 265 858 856 265 858 856 265 858 856 265 858 856 265 858 856 265 858 856 265 858 856 265 858 856 265 858 856 265 858 856 265 858 856 265 858 856 265 858 856 265 858 856 265 858 856 265 858 856 265 858 856 265 858 856 265 858 856 265 858 856 265 858 856 265 858 856 265 858 856 265 858 856 265 858 856 265 858 856 265 858 856 265 858 856 265 858 856 265 858 856 265 858 856 265 858 856 265 858 856 265 858 856 265 858 856 265 858 856 265 858 856 265 858 856 265 858 856 265 858 856 265 858 856 265 858 856 265 858 856 265 858 0 0 0 0 0 0 0 183 183 183 183 183 183 0 0 0 0 0 0 0 0 0 0
0 0 0 0 0 0 0 0 0 0 888 889 890 888 889 890 888 889 890 728 728 888 889 890 888 889 890 888 889 890 888 889 890 888 889 890 888 889 890 888 889 890 888 889 890 888 889 890 888 889 890 888 889 890 888 889 890 888 889 890 888 889 890 888 889 890 888 889 890 888 889 890 888 889 890 888 889 890 888 889 890 888 889 890 888 889 890 888 889 890 888 889 890 888 889 890 888 889 890 888 889 890 888 889 890 888 889 890 888 889 890 888 889 890 888 889 890 888 889 890 888 889 890 888 889 890 888 889 890 888 889 890 888 889 890 888 889 890 888 889 890 888 889 890 888 889 890 888 889 890 888 889 890 888 889 890 888 889 890 888 889 890 888 889 890 888 889 890 888 889 890 888 889 890 888 889 890 0 0 0 0 0 0 0 183 183 183 183 183 183 0 0 0 0 0 0 0 0 0 0
