TILEMAP
200 20        -- Size of tile map in tiles
16 16        -- Tile size & block size
textures/green_tile.png  -- Tilesheet
32 32         -- Number of tiles in tilesheet
0 0 0 0 0 0 0 0 0 0 823 824 825 823 824 825 823 824 825 631 631 823 824 825 823 824 825 823 824 825 823 824 825 823 824 825 823 824 825 823 824 825 823 824 825 823 824 825 823 824 825 823 824 825 823 824 825 823 824 825 823 824 825 823 824 825 823 824 825 823 824 825 823 824 825 823 824 825 823 824 825 823 824 825 823 824 825 823 824 825 823 824 825 823 824 825 823 824 825 823 824 825 823 824 825 823 824 825 823 824 825 823 824 825 823 824 825 823 824 825 823 824 825 823 824 825 823 824 825 823 824 825 823 824 825 823 824 825 823 824 825 823 824 825 823 824 825 823 824 825 823 824 825 823 824 825 823 824 825 823 824 825 823 824 825 823 824 825 823 824 825 823 824 825 823 824 825 0 0 0 0 0 0 182 182 182 182 182 182 182 0 0 0 0 0 0 0 0 0 0
0 0 0 0 0 0 0 0 0 0 855 264 857 855 264 857 855 264 857 663 663 855 264 857 855 264 857 855 264 857 855 264 857 855 264 857 855 264 857 855 264 857 855 264 857 855 264 857 855 264 857 855 264 857 855 264 857 855 264 857 855 264 857 855 264 857 855 264 857 855 264 857 855 264 857 855 264 857 855 264 857 855 264 857 855 264 857 855 264 857 855 264 857 855 264 857 855 264 857 855 264 857 855 264 857 855 264 857 855 264 857 855 264 857 855 264 857 855 264 857 855 264 857 855 264 857 855 264 857 855 264 857 855 264 857 855 264 857 855 264 857 855 264 857 855 264 857 855 264 857 855 264 857 855 264 857 855 264 857 855 264 857 855 264 857 855 264 857 855 264 857 855 264 857 855 264 857 0 0 0 0 0 0 182 182 182 182 182 182 182 0 0 0 0 0 0 0 0 0 0
0 0 0 0 0 0 0 0 0 0 887 888 889 887 888 889 887 888 889 695 695 887 888 889 887 888 889 887 888 889 887 888 889 887 888 889 887 888 889 887 888 889 887 888 889 887 888 889 887 888 889 887 888 889 887 888 889 887 888 889 887 888 889 887 888 889 887 888 889 887 888 889 887 888 889 887 888 889 887 888 889 887 888 889 887 888 889 887 888 889 887 888 889 887 888 889 887 888 889 887 888 889 887 888 889 887 888 889 887 888 889 887 888 889 887 888 889 887 888 889 887 888 889 887 888 889 887 888 889 887 888 889 887 888 889 887 888 889 887 888 889 887 888 889 887 888 889 887 888 889 887 888 889 887 888 889 887 888 889 887 888 889 887 888 889 887 888 889 887 888 889 887 888 889 887 888 889 0 0 0 0 0 0 182 182 182 182 182 182 182 0 0 0 0 0 0 0 0 0 0
0 0 0 0 0 0 0 0 0 0 264 264 264 264 264 264 264 264 264 727 727 264 264 264 264 264 264 264 264 264 264 264 264 264 264 264 264 264 264 264 264 264 264 264 264 264 264 264 264 264 264 264 264 264 264 264 264 264 264 264 264 264 264 264 264 264 264 264 264 264 264 264 264 264 264 264 264 264 264 264 264 264 264 264 264 264 264 264 264 264 264 264 264 264 264 264 264 264 264 264 264 264 264 264 264 264 264 264 264 264 264 264 264 264 264 264 264 264 264 264 264 264 264 264 264 264 264 264 264 264 264 264 264 264 264 264 264 264 264 264 264 264 264 264 264 264 264 264 264 264 264 264 264 264 264 264 264 264 264 264 264 264 264 264 264 264 264 264 264 264 264 264 264 264 264 264 264 0 0 0 0 0 0 182 182 182 182 182 182 182 0 0 0 0 0 0 0 0 0 0
0 0 0 0 0 0 0 0 0 0 0 0 0 0 0 0 0 0 396 631 631 396 0 0 0 0 0 0 0 0 0 0 0 0 0 0 0 0 0 0 0 0 0 0 0 0 0 0 0 0 0 0 0 0 0 0 0 0 0 0 0 0 0 0 0 0 0 0 0 0 0 0 0 0 0 0 0 0 0 789 626 789 789 629 626 789 789 629 626 789 789 629 626 789 789 629 626 789 789 629 0 0 0 0 0 0 0 0 0 0 0 0 0 0 0 0 0 0 0 0 0 0 0 0 0 0 0 0 0 0 0 0 0 0 0 0 0 0 0 0 0 0 0 0 0 0 0 0 0 0 0 0 0 0 0 0 0 0 0 0 0 0 0 0 0 0 0 0 0 0 0 0 0 0 0 0 0 0 0 0 0 0 0 182 182 182 182 182 182 182 0 0 0 0 0 0 0 0 0 0
0 0 0 0 0 0 0 0 0 0 0 0 0 0 0 0 0 0 396 663 663 396 0 0 0 0 0 0 0 0 0 0 0 0 0 0 0 0 0 0 0 0 0 0 0 0 0 0 0 0 0 0 0 0 0 0 0 0 0 0 0 0 0 0 0 0 0 0 0 0 0 0 0 0 0 0 0 0 0 789 658 659 660 661 658 659 660 661 658 659 660 661 658 659 660 661 658 659 660 661 0 0 0 0 0 0 0 0 0 0 0 0 0 0 0 0 0 0 0 0 0 0 0 0 0 0 0 0 0 0 0 0 0 0 0 0 0 0 0 0 0 0 0 0 0 0 0 0 0 0 0 0 0 0 0 0 0 0 0 0 0 24 25 28 29 0 0 0 0 24 25 26 27 0 0 0 0 0 0 0 0 30 31 182 182 182 182 182 182 182 0 0 0 0 0 0 0 0 0 0
0 0 0 0 0 0 0 0 0 0 0 0 0 0 0 0 0 0 396 695 695 396 0 488 488 488 488 488 488 488 488 488 0 0 0 0 0 0 0 0 0 0 0 0 0 0 0 0 0 0 0 0 0 0 0 0 0 0 0 0 0 0 0 0 0 0 0 0 0 0 0 0 0 0 0 0 0 0 0 789 690 691 692 693 690 691 692 693 690 691 692 693 690 691 692 693 690 691 692 693 0 0 0 0 0 0 0 0 0 0 0 0 0 0 0 0 0 0 0 0 0 0 0 0 0 0 0 0 0 0 0 0 0 0 0 0 0 0 0 0 0 0 0 0 0 0 0 0 0 0 0 0 0 0 0 0 0 0 0 24 25 56 57 60 61 28 29 24 25 56 57 58 59 26 27 0 0 0 0 30 31 62 63 0 0 0 0 0 0 0 0 0 0 0 0 0 0 0 0 0
0 0 0 0 0 0 0 0 0 0 0 0 0 0 0 0 0 0 396 727 727 396 0 0 0 0 0 0 0 0 0 488 0 0 488 488 488 488 488 488 488 488 488 488 0 0 0 0 284 285 286 284 285 286 284 285 286 284 285 286 284 285 286 284 285 286 284 285 286 284 285 286 284 285 286 0 0 0 0 789 722 789 789 725 722 789 789 725 722 789 789 725 722 789 789 725 722 789 789 725 388 389 390 388 389 390 388 389 388 389 390 388 389 390 388 389 390 388 389 390 745 746 747 748 745 746 747 745 746 747 748 745 746 747 748 745 746 747 748 745 746 747 748 745 746 747 748 745 746 747 748 745 746 747 748 745 746 747 748 56 57 0 0 0 0 60 61 56 57 0 0 0 0 58 59 26 27 30 31 62 63 0 0 0 0 0 0 0 0 0 0 0 0 0 0 0 0 0 0 0
0 0 0 0 0 0 0 0 0 0 0 0 0 0 0 0 0 0 428 428 428 428 0 0 0 0 0 0 0 0 0 488 0 0 0 0 0 0 0 0 0 0 0 0 0 0 0 0 316 520 318 316 520 318 316 520 318 316 520 318 316 520 318 316 520 318 316 520 318 316 520 318 316 520 318 0 0 0 0 0 0 0 0 0 0 0 0 0 0 0 0 0 0 0 0 0 0 0 0 0 0 0 0 0 0 0 0 0 0 0 0 0 0 0 0 0 0 0 0 0 0 0 0 0 0 0 0 0 0 0 0 0 0 0 0 0 0 0 0 0 0 0 0 0 0 0 0 0 0 0 0 0 0 0 0 0 0 0 0 0 0 0 0 0 0 0 0 0 0 0 0 0 0 0 0 58 59 62 63 0 0 0 0 0 0 0 0 0 0 0 0 0 0 0 0 0 0 0 0 0
0 0 0 0 0 0 0 0 0 0 0 0 0 0 0 0 0 0 0 0 0 0 0 0 0 0 0 0 0 0 0 488 0 0 0 0 0 0 0 0 0 0 0 0 0 0 0 0 348 349 350 348 349 350 348 349 350 348 349 350 348 349 350 348 349 350 348 349 350 348 349 350 348 349 350 0 0 0 0 0 0 0 0 0 0 0 0 0 0 0 0 0 0 0 0 0 0 0 0 0 0 0 0 0 0 39 39 39 39 39 39 39 39 39 39 0 0 0 0 0 0 0 0 39 39 39 39 39 39 39 39 0 0 0 0 0 0 0 0 0 0 0 0 0 0 0 0 0 0 0 0 0 0 0 0 0 0 0 0 0 0 0 0 0 0 0 0 0 0 0 0 0 0 0 0 0 0 0 0 0 0 0 0 0 0 0 0 0 0 0 0 0 0 0 0 0 0 0 0 0
0 0 0 0 0 0 0 0 0 0 0 0 0 0 0 0 0 0 0 0 0 0 0 0 0 0 0 0 0 0 0 0 0 488 488 488 488 488 488 488 488 488 488 488 0 0 0 0 0 0 0 0 0 0 0 0 0 0 0 0 0 0 0 0 0 0 0 0 0 0 0 0 0 0 0 0 0 0 0 789 626 789 789 629 626 789 789 629 626 789 789 629 626 789 789 629 626 789 789 629 0 0 0 0 40 749 750 749 750 749 750 749 750 749 750 7 0 0 0 0 0 0 40 749 750 749 750 749 750 749 750 7 0 0 0 0 39 39 0 0 0 40 749 750 749 750 749 750 749 750 749 750 7 0 0 0 0 0 0 0 0 0 0 0 0 0 0 0 0 0 0 0 0 0 0 0 0 0 0 0 0 0 0 0 0 0 0 0 0 0 0 0 0 0 0 0 0 0 0 0
0 0 0 0 0 0 0 0 0 0 0 0 0 0 0 0 0 0 428 428 428 428 0 488 0 0 0 0 0 0 0 0 0 0 0 0 0 0 0 0 0 0 0 0 0 0 0 0 0 0 0 0 0 0 0 0 0 0 0 0 0 0 0 0 0 0 0 0 0 0 0 0 0 0 0 0 0 0 0 789 658 659 660 661 658 659 660 661 658 659 660 661 658 659 660 661 658 659 660 661 0 0 0 0 40 781 782 781 782 781 782 781 782 781 782 7 0 0 0 0 0 0 40 781 782 781 782 781 782 781 782 7 0 0 0 0 8 8 0 0 0 40 781 782 781 782 781 782 781 782 781 782 7 0 0 0 0 0 0 0 0 0 24 25 28 29 0 0 0 0 0 0 0 0 30 31 26 27 0 0 0 0 0 0 0 0 0 0 0 0 0 0 0 0 0 0 0 0 0 0
0 0 0 0 0 0 0 0 0 0 0 0 0 0 0 0 0 0 396 631 631 396 0 488 0 0 0 0 0 0 0 0 0 0 0 0 0 0 0 0 0 0 0 0 363 363 363 363 363 363 363 363 363 363 363 363 363 363 363 363 363 363 363 363 363 363 363 363 363 363 363 363 363 363 363 363 363 363 363 363 690 691 692 693 690 691 692 693 690 691 692 693 690 691 692 693 690 691 692 693 0 0 0 0 0 0 0 0 0 0 0 0 0 0 0 0 0 0 0 0 0 0 0 0 0 0 0 0 0 0 0 0 0 0 0 0 0 0 0 0 0 0 8 8 8 8 8 8 8 8 8 8 0 0 0 0 0 0 0 0 24 25 56 57 60 61 28 29 0 0 0 0 30 31 62 63 58 59 26 27 0 0 0 0 0 0 0 0 0 0 0 0 0 0 0 0 0 0 0 0
0 0 0 0 0 0 0 0 0 0 0 0 0 0 0 0 0 0 396 663 663 396 0 488 488 488 488 488 488 488 488 488 0 0 0 488 488 488 488 488 488 488 488 488 423 424 425 423 424 425 423 424 425 423 424 425 423 424 425 423 424 425 423 424 425 423 424 425 423 424 425 423 424 425 423 424 425 423 424 425 722 789 789 725 722 789 789 725 722 789 789 725 722 789 789 725 722 789 789 725 428 428 428 428 428 428 428 428 428 428 428 428 428 428 428 428 428 428 0 0 0 0 0 0 0 0 0 0 0 0 0 0 0 0 0 0 0 0 0 0 0 0 0 0 0 0 0 0 0 0 0 0 0 0 0 0 0 0 24 25 56 57 0 0 0 0 60 61 28 29 30 31 62 63 0 0 0 0 58 59 26 27 0 0 0 0 0 0 0 0 0 0 0 0 0 0 0 0 0 0
0 0 0 0 0 0 0 0 0 0 0 0 0 0 0 0 0 0 396 695 695 396 0 0 0 0 0 0 0 0 0 0 0 0 0 488 0 0 0 0 0 0 0 0 0 0 0 0 0 0 0 0 0 0 0 0 0 0 0 0 0 0 0 0 0 0 0 0 0 0 0 0 0 0 0 0 0 0 0 0 0 0 0 0 0 0 0 0 0 0 0 0 0 0 0 0 0 0 0 0 489 490 491 523 524 523 524 523 524 523 524 523 524 523 524 523 524 524 745 746 747 748 745 746 747 748 745 746 747 748 745 746 747 748 745 746 747 748 745 746 747 748 745 746 747 748 745 746 747 748 745 746 747 748 745 746 747 748 56 57 0 0 0 0 0 0 0 0 60 61 62 63 0 0 0 0 0 0 0 0 58 59 26 27 0 0 0 0 0 0 0 0 0 0 0 0 0 0 0 0
0 0 0 0 0 0 0 0 0 0 0 0 0 0 0 0 0 0 396 727 727 396 0 0 0 0 0 0 0 0 0 0 0 0 0 0 0 0 0 0 0 0 0 0 0 0 0 0 0 0 0 0 0 0 0 0 0 0 0 0 0 0 0 0 0 0 0 0 0 0 0 0 0 0 0 0 0 0 0 0 0 0 0 0 0 0 0 0 0 0 0 0 0 0 0 0 0 0 0 0 0 0 0 0 0 0 0 0 0 0 0 0 0 0 0 0 0 0 0 0 0 0 0 0 0 0 0 0 0 0 0 0 0 0 0 0 0 0 0 0 0 0 0 0 0 0 0 0 0 0 0 0 0 0 0 0 0 0 0 0 0 0 0 0 0 0 0 0 0 0 0 0 0 0 0 0 0 0 0 0 0 0 58 59 182 182 182 182 182 182 0 0 0 0 0 0 0 0 0 0
0 0 0 0 0 0 0 0 0 0 264 264 264 264 264 264 264 264 264 631 631 264 264 264 264 264 264 264 264 264 264 264 264 264 264 264 264 264 264 264 264 264 264 264 264 264 264 264 264 264 264 264 264 264 264 264 264 264 264 264 264 264 264 264 264 264 264 264 264 264 264 264 264 264 264 264 264 264 264 264 264 264 264 264 264 264 264 264 264 264 264 264 264 264 264 264 264 264 264 264 264 264 264 264 264 264 264 264 264 264 264 264 264 264 264 264 264 264 264 264 264 264 264 264 264 264 264 264 264 264 264 264 264 264 264 264 264 264 264 264 264 264 264 264 264 264 264 264 264 264 264 264 264 264 264 264 264 264 264 264 264 264 264 264 264 264 264 264 264 264 264 264 264 264 264 264 264 0 0 0 0 0 0 0 182 182 182 182 182 182 0 0 0 0 0 0 0 0 0 0
0 0 0 0 0 0 0 0 0 0 823 824 825 823 824 825 823 824 825 663 663 823 824 825 823 824 825 823 824 825 823 824 825 823 824 825 823 824 825 823 824 825 823 824 825 823 824 825 823 824 825 823 824 825 823 824 825 823 824 825 823 824 825 823 824 825 823 824 825 823 824 825 823 824 825 823 824 825 823 824 825 823 824 825 823 824 825 823 824 825 823 824 825 823 824 825 823 824 825 823 824 825 823 824 825 823 824 825 823 824 825 823 824 825 823 824 825 823 824 825 823 824 825 823 824 825 823 824 825 823 824 825 823 824 825 823 824 825 823 824 825 823 824 825 823 824 825 823 824 825 823 824 825 823 824 825 823 824 825 823 824 825 823 824 825 823 824 825 823 824 825 823 824 825 823 824 825 0 0 0 0 0 0 0 182 182 182 182 182 182 0 0 0 0 0 0 0 0 0 0
0 0 0 0 0 0 0 0 0 0 855 264 857 855 264 857 855 264 857 695 695 855 264 857 855 264 857 855 264 857 855 264 857 855 264 857 855 264 857 855 264 857 855 264 857 855 264 857 855 264 857 855 264 857 855 264 857 855 264 857 855 264 857 855 264 857 855 264 857 855 264 857 855 264 857 855 264 857 855 264 857 855 264 857 855 264 857 855 264 857 855 264 857 855 264 857 855 264 857 855 264 857 855 264 857 855 264 857 855 264 857 855 264 857 855 264 857 855 264 857 855 264 857 855 264 857 855 264 857 855 264 857 855 264 857 855 264 857 855 264 857 855 264 857 855 264 857 855 264 857 855 264 857 855 264 857 855 264 857 855 264 857 855 264 857 855 264 857 855 264 857 855 264 857 855 264 857 0 0 0 0 0 0 0 182 182 182 182 182 182 0 0 0 0 0 0 0 0 0 0
0 0 0 0 0 0 0 0 0 0 887 888 889 887 888 889 887 888 889 727 727 887 888 889 887 888 889 887 888 889 887 888 889 887 888 889 887 888 889 887 888 889 887 888 889 887 888 889 887 888 889 887 888 889 887 888 889 887 888 889 887 888 889 887 888 889 887 888 889 887 888 889 887 888 889 887 888 889 887 888 889 887 888 889 887 888 889 887 888 889 887 888 889 887 888 889 887 888 889 887 888 889 887 888 889 887 888 889 887 888 889 887 888 889 887 888 889 887 888 889 887 888 889 887 888 889 887 888 889 887 888 889 887 888 889 887 888 889 887 888 889 887 888 889 887 888 889 887 888 889 887 888 889 887 888 889 887 888 889 887 888 889 887 888 889 887 888 889 887 888 889 887 888 889 887 888 889 0 0 0 0 0 0 0 182 182 182 182 182 182 0 0 0 0 0 0 0 0 0 0

