TILEMAP
200 20        -- Size of tile map in tiles
16 16        -- Tile size & block size
textures/green_tile.png  -- Tilesheet
32 32         -- Number of tiles in tilesheet
28 29 0 0 0 0 0 0 0 0 0 0 0 0 0 0 0 0 24 25 28 29 0 0 0 0 0 0 0 0 0 0 0 0 0 0 0 0 24 25 28 29 0 0 0 0 0 0 0 0 0 0 0 0 0 0 0 0 24 25 0 0 0 0 0 0 0 0 0 0 0 0 0 0 0 0 0 0 0 0 0 0 0 0 0 0 0 0 0 0 0 0 0 0 0 0 0 0 0 0 0 0 0 0 623 561 553 554 555 556 557 558 553 554 555 556 557 558 553 554 555 556 557 558 553 554 555 556 557 558 553 554 555 556 557 558 553 554 555 556 557 558 451 452 451 452 451 452 451 452 451 452 451 452 451 452 451 452 451 452 780 780 780 780 780 780 780 780 780 780 780 780 780 780 780 780 780 780 780 780 625 0 0 0 0 0 0 0 0 0 0 0 0 0 0 0 0 0 0 0
60 61 28 29 0 0 0 0 0 0 0 0 0 0 0 0 24 25 56 57 60 61 28 29 0 0 0 0 0 0 0 0 0 0 0 0 24 25 56 57 60 61 28 29 0 0 0 0 0 0 0 0 0 0 0 0 24 25 56 57 0 0 0 0 0 0 0 0 0 0 0 0 0 0 0 0 0 0 0 0 0 0 0 0 0 0 0 0 0 0 0 0 0 0 0 0 0 0 0 0 0 0 0 0 655 593 585 586 587 588 589 590 585 586 587 588 589 590 585 586 587 588 589 590 585 586 587 588 589 590 585 586 587 588 589 590 585 586 587 588 589 590 483 484 483 484 483 484 483 484 483 484 483 484 483 484 483 484 483 484 780 780 780 780 780 780 780 780 780 780 780 780 780 780 780 780 780 780 780 780 657 0 0 0 0 0 0 0 0 0 0 0 0 0 0 0 0 0 0 0
0 0 60 61 28 29 0 0 0 0 0 0 0 0 24 25 56 57 0 0 0 0 60 61 28 29 0 0 0 0 0 0 0 0 24 25 56 57 0 0 0 0 60 61 28 29 0 0 0 0 0 0 0 0 24 25 56 57 0 0 0 0 0 0 0 0 0 0 0 0 0 0 0 0 0 0 0 0 0 0 0 0 0 0 0 0 0 0 0 0 0 0 0 0 0 0 0 0 0 0 0 0 0 0 687 561 561 561 561 561 0 0 0 0 0 0 0 0 0 0 0 0 0 0 0 0 0 0 0 0 0 264 621 264 0 0 0 0 0 0 0 0 0 0 0 0 0 0 0 0 0 0 0 0 0 0 0 0 0 0 0 0 0 0 0 0 0 0 0 0 0 0 0 0 0 0 0 0 0 0 689 0 0 0 0 0 0 0 0 0 0 0 0 0 0 0 0 0 0 0
0 0 0 0 60 61 28 29 0 0 0 0 24 25 56 57 0 0 0 0 0 0 0 0 60 61 28 29 0 0 0 0 24 25 56 57 0 0 0 0 0 0 0 0 60 61 28 29 0 0 0 0 24 25 56 57 0 0 0 0 0 0 0 0 0 0 0 0 0 0 0 0 0 0 0 0 0 0 0 0 0 0 0 0 0 0 0 0 0 0 0 0 0 0 0 0 0 0 0 0 0 0 0 0 623 593 593 593 593 593 0 0 0 0 0 0 0 0 0 0 0 0 0 0 0 0 0 0 0 0 0 264 653 264 0 0 0 0 0 0 0 0 0 0 0 0 0 0 0 0 0 0 0 0 0 0 0 0 0 0 0 0 0 0 0 0 0 0 0 0 0 0 0 0 0 0 0 0 0 0 625 0 0 0 0 0 0 0 0 0 0 0 0 0 0 0 0 0 0 0
0 0 0 0 0 0 60 61 28 29 24 25 56 57 0 0 0 0 0 0 0 0 0 0 0 0 60 61 28 29 24 25 56 57 0 0 0 0 0 0 0 0 0 0 0 0 60 61 28 29 24 25 56 57 0 0 0 0 0 0 0 0 0 0 0 0 0 0 0 0 0 0 0 0 0 0 0 0 0 0 0 0 0 0 0 0 0 0 0 0 0 0 0 0 0 0 0 0 0 0 0 0 0 0 655 561 561 561 561 561 0 0 0 0 0 0 0 0 0 0 0 0 0 0 0 0 0 0 0 0 0 264 685 264 0 0 0 0 0 0 0 0 0 0 0 0 0 0 0 0 0 0 0 0 0 0 0 0 0 0 0 0 0 0 0 0 0 0 0 0 0 0 0 0 0 0 0 0 0 0 657 0 0 0 0 0 0 0 0 0 0 0 0 0 0 0 0 0 0 0
0 0 0 0 0 0 0 0 60 61 56 57 0 0 0 0 0 0 0 0 0 0 0 0 0 0 0 0 60 61 56 57 0 0 0 0 0 0 0 0 0 0 0 0 0 0 0 0 60 61 56 57 0 0 0 0 0 0 0 0 0 0 0 0 0 0 0 0 0 0 0 0 0 0 0 0 0 0 0 0 0 0 0 0 0 0 0 0 0 0 0 0 0 0 0 0 0 0 0 0 0 0 0 0 687 593 593 593 593 593 0 0 0 0 0 0 0 0 0 0 0 0 0 0 0 0 0 0 0 0 0 264 717 264 0 0 0 0 0 0 0 0 0 0 0 0 0 0 0 0 0 0 0 0 0 0 0 0 0 0 0 0 0 0 0 0 0 0 0 0 0 0 0 0 0 0 0 0 0 0 689 0 0 0 0 0 0 0 0 0 0 0 0 0 0 0 0 0 0 0
138 138 138 138 138 138 138 138 138 138 138 138 138 138 138 138 138 138 138 138 138 138 138 138 138 138 138 138 138 138 138 138 138 138 138 138 138 138 138 138 138 138 138 138 138 138 138 138 138 138 138 0 0 0 0 0 0 0 0 0 0 0 0 0 0 0 0 0 0 0 0 0 0 0 0 0 0 0 0 0 0 0 0 0 0 0 0 0 0 0 0 0 0 0 0 0 0 0 0 0 0 0 0 0 0 0 0 0 0 0 0 0 0 0 0 0 0 0 0 0 0 0 0 0 0 0 0 0 0 0 0 264 621 264 0 0 0 0 0 0 0 0 0 0 0 0 0 0 0 0 0 0 0 0 0 0 0 0 0 0 0 0 0 0 0 0 0 0 0 0 0 0 0 0 0 0 0 0 0 0 625 0 0 0 0 0 0 0 0 0 0 0 0 0 0 0 0 0 0 0
332 332 332 332 332 332 332 332 332 332 332 332 332 332 332 332 332 332 332 332 332 332 332 332 332 332 332 332 332 332 332 332 332 332 332 332 332 332 332 332 332 332 332 332 332 332 332 332 332 332 332 0 0 0 0 0 0 0 0 0 0 0 0 0 0 0 0 0 0 0 0 0 0 0 0 0 0 0 0 0 0 0 0 0 0 0 0 0 0 0 0 0 0 0 0 0 0 0 0 0 0 0 0 0 0 0 0 0 0 0 0 0 0 0 0 0 0 0 0 0 0 0 0 0 0 0 0 0 0 0 0 264 653 264 0 0 0 0 0 0 0 0 0 0 0 0 0 0 0 0 0 0 0 0 0 0 0 0 0 0 0 0 0 0 0 0 0 0 0 0 0 0 0 0 0 0 0 0 0 0 657 0 0 0 0 0 0 0 0 0 0 0 0 0 0 0 0 0 0 0
0 0 0 0 0 0 0 0 0 0 232 0 0 0 0 0 0 0 0 0 0 0 0 0 0 232 0 0 0 0 0 232 0 0 0 0 0 264 0 0 0 0 0 0 264 0 0 0 0 0 0 0 0 0 0 0 0 0 0 0 0 0 0 0 0 0 0 0 0 0 0 0 0 0 0 0 0 0 0 0 0 0 0 0 0 0 0 0 0 0 0 0 0 0 0 0 0 0 0 0 0 0 0 0 0 0 0 0 0 0 0 0 0 0 0 0 0 0 0 0 0 0 0 0 0 0 0 0 0 0 0 264 685 264 0 0 0 0 0 0 0 0 0 0 0 0 0 0 0 0 0 0 0 0 0 0 0 0 0 0 0 0 0 0 0 0 0 0 0 0 0 0 0 0 0 0 0 0 0 0 689 0 0 0 0 0 0 0 0 0 0 0 0 0 0 0 0 0 0 0
0 0 0 0 0 0 0 0 0 0 0 0 0 0 0 0 0 0 0 0 0 0 0 0 0 0 0 0 0 0 0 0 0 0 0 0 0 0 0 0 0 0 0 0 0 0 0 0 0 0 0 0 0 0 0 0 0 0 0 0 0 0 0 0 0 0 0 0 0 0 0 0 0 0 0 0 0 0 0 0 0 0 0 0 0 0 0 0 0 0 0 0 0 0 0 0 0 0 0 0 0 0 0 0 623 751 751 752 751 752 751 752 751 752 751 752 751 752 752 0 0 0 0 0 0 0 0 0 0 0 0 264 717 264 0 0 0 0 0 0 0 0 0 0 0 0 0 0 0 0 0 0 0 0 0 0 0 0 0 0 0 0 0 0 0 0 0 0 0 0 0 0 0 0 0 0 0 0 0 0 625 0 0 0 0 0 0 0 0 0 0 0 0 0 0 0 0 0 0 0
0 0 0 0 0 0 0 0 0 0 0 0 0 0 0 0 0 0 0 0 0 0 0 0 0 0 0 0 0 0 0 0 0 0 0 0 0 0 0 0 0 0 0 0 0 0 0 0 0 0 0 0 0 0 0 0 0 0 0 0 0 0 0 0 0 0 0 0 0 0 0 0 0 0 0 0 0 0 0 0 0 0 0 0 0 0 0 0 0 0 0 0 0 0 0 0 0 0 0 0 0 0 0 0 655 783 783 784 783 784 783 784 783 784 783 784 783 784 784 0 0 0 0 0 0 0 0 0 0 0 0 0 0 0 0 0 0 0 0 0 0 0 0 0 0 0 0 0 0 0 0 0 0 0 0 0 0 0 0 0 0 0 0 0 0 0 0 0 0 0 0 0 0 0 0 0 0 0 0 0 657 0 0 0 0 0 0 0 0 0 0 0 0 0 0 0 0 0 0 0
0 0 0 0 0 0 0 0 0 0 232 0 0 0 0 0 0 0 0 0 0 0 0 0 0 232 0 0 0 0 0 232 0 0 0 0 0 264 0 0 0 0 0 0 264 0 0 0 0 0 0 0 0 0 0 0 0 0 0 0 0 0 0 0 0 0 0 0 0 0 0 0 0 0 0 0 0 0 0 0 0 0 0 0 0 0 0 0 0 0 0 0 0 0 0 0 0 0 0 0 0 0 0 0 687 751 617 618 619 620 617 618 619 620 617 618 619 620 689 0 0 0 0 0 0 0 0 0 0 0 0 0 0 0 0 0 0 0 0 0 0 0 0 0 0 0 0 0 0 0 0 0 0 0 0 0 0 0 0 0 0 0 0 0 0 0 0 0 0 0 0 0 0 0 0 0 0 0 0 0 689 0 0 0 0 0 0 0 0 0 0 0 0 0 0 0 0 0 0 0
363 363 363 363 363 363 363 363 363 363 363 363 363 363 363 363 363 363 363 363 363 363 363 363 363 363 363 363 363 363 363 363 363 363 363 363 363 363 363 363 363 363 363 363 363 363 363 363 363 363 363 0 0 0 0 0 0 0 0 0 0 0 0 0 0 0 0 0 0 0 0 0 0 0 0 0 0 0 0 0 0 0 0 0 0 0 0 0 0 0 0 0 0 0 0 0 0 0 0 0 0 0 0 0 623 783 649 650 651 652 649 650 651 652 649 650 651 652 625 0 0 0 0 0 0 0 0 0 0 0 0 264 621 264 0 0 0 0 0 0 0 0 0 0 0 0 0 0 0 0 0 0 0 0 0 0 0 0 0 0 0 0 0 0 0 0 0 0 0 0 0 0 0 0 0 0 0 0 0 0 625 0 0 0 0 0 0 0 0 0 0 0 0 0 0 0 0 0 0 0
384 385 386 384 385 386 384 385 386 384 385 386 384 385 386 384 385 386 384 385 386 384 385 386 384 385 386 384 385 386 384 385 386 384 385 386 384 385 386 384 385 386 384 385 386 384 385 386 384 385 386 0 0 0 0 0 0 0 0 0 0 0 0 0 0 0 0 0 0 0 0 0 0 0 0 0 0 0 0 0 0 0 0 0 0 0 0 0 0 0 0 0 88 89 90 91 0 0 0 0 0 0 0 0 655 751 681 682 683 684 681 682 683 684 681 682 683 684 657 0 0 0 0 0 0 0 0 0 0 0 0 264 685 264 0 0 0 0 0 0 0 0 0 0 0 0 0 0 0 0 0 0 0 0 0 0 0 0 0 0 0 0 0 0 0 0 0 0 0 0 0 0 0 0 0 0 0 0 0 0 657 0 0 0 0 0 0 0 0 0 0 0 0 0 0 0 0 0 0 0
0 0 0 0 0 0 0 0 24 25 28 29 0 0 0 0 0 0 0 0 0 0 0 0 0 0 0 0 24 25 28 29 0 0 0 0 0 0 0 0 0 0 0 0 0 0 0 0 24 25 28 29 0 0 0 0 0 0 0 0 0 0 0 0 0 0 0 0 0 0 0 0 0 0 0 0 0 0 0 0 0 0 0 0 0 0 0 0 0 0 88 89 120 121 122 123 90 91 0 0 0 0 0 0 687 783 713 714 715 716 713 714 715 716 713 714 715 716 689 0 0 0 0 0 0 0 0 0 0 0 0 264 717 264 0 0 0 0 0 0 0 0 0 0 0 0 0 0 0 0 0 0 0 0 0 0 0 0 0 0 0 0 0 0 0 0 0 0 0 0 0 0 0 0 0 0 0 0 0 0 689 0 0 0 0 0 0 0 0 0 0 0 0 0 0 0 0 0 0 0
0 0 0 0 0 0 24 25 56 57 60 61 28 29 0 0 0 0 0 0 0 0 0 0 0 0 24 25 56 57 60 61 28 29 0 0 0 0 0 0 0 0 0 0 0 0 24 25 56 57 60 61 28 29 0 0 0 0 0 0 0 0 0 0 0 0 0 0 0 0 0 0 0 0 0 0 0 0 0 0 0 0 0 0 0 0 0 0 88 89 120 121 121 121 121 122 122 123 90 91 0 0 0 0 623 751 617 618 619 620 617 618 619 620 617 618 619 620 625 0 0 0 0 0 0 0 0 0 0 0 0 264 621 264 0 0 0 0 0 0 0 0 0 0 0 0 0 0 0 0 0 0 0 0 0 0 0 0 0 0 0 0 0 0 0 0 0 0 0 0 0 0 0 0 0 0 0 0 0 0 0 0 0 0 0 0 0 0 0 0 0 0 0 0 0 0 0 0 0 0
0 0 0 0 24 25 56 57 0 0 0 0 60 61 28 29 0 0 0 0 0 0 0 0 24 25 56 57 0 0 0 0 60 61 28 29 0 0 0 0 0 0 0 0 24 25 56 57 0 0 0 0 60 61 28 29 0 0 0 0 0 0 0 0 0 0 0 0 0 0 0 0 0 0 0 0 0 0 0 0 0 0 0 0 0 0 88 89 120 121 121 121 121 121 121 121 121 122 122 123 90 91 0 0 655 783 649 650 651 652 649 650 651 652 649 650 651 652 657 0 0 0 0 0 0 0 0 0 0 0 0 264 653 264 0 0 0 0 0 0 0 0 0 0 0 0 0 0 0 0 0 0 0 0 0 0 0 0 0 0 0 0 0 0 0 0 0 0 0 0 0 0 0 0 0 0 0 0 0 0 0 0 0 0 0 0 0 0 0 0 0 0 0 0 0 0 0 0 0 0
0 0 24 25 56 57 0 0 0 0 0 0 0 0 60 61 28 29 0 0 0 0 24 25 56 57 0 0 0 0 0 0 0 0 60 61 28 29 0 0 0 0 24 25 56 57 0 0 0 0 0 0 0 0 60 61 28 29 0 0 0 0 0 0 166 167 0 0 166 167 0 0 0 0 0 166 167 0 0 0 0 0 166 167 88 89 120 121 121 121 121 121 121 121 121 121 121 121 121 122 122 123 90 91 687 751 681 682 683 684 681 682 683 684 681 682 683 684 689 0 0 0 0 0 0 0 0 0 0 0 0 264 685 264 0 0 0 0 0 0 0 0 0 0 0 0 0 0 0 0 0 0 0 0 0 0 0 0 0 0 428 428 428 428 428 428 428 428 428 428 428 428 428 428 428 428 428 428 428 428 428 428 428 428 0 0 0 0 0 0 0 0 0 0 0 0 0 0 0 0
24 25 56 57 0 0 0 0 0 0 0 0 0 0 0 0 60 61 28 29 24 25 56 57 0 0 0 0 0 0 0 0 0 0 0 0 60 61 28 29 24 25 56 57 0 0 0 0 0 0 0 0 0 0 0 0 60 61 28 29 0 0 0 0 198 199 0 0 198 199 0 0 0 0 0 198 199 0 0 0 0 0 198 199 120 121 121 121 121 121 121 121 121 121 121 121 121 122 121 121 121 122 122 123 198 783 713 714 715 716 713 714 715 716 713 714 715 716 505 506 264 505 506 264 505 506 264 505 506 264 505 506 717 505 506 507 505 506 507 451 452 451 452 451 452 451 452 451 451 452 451 452 451 452 451 452 451 452 451 452 521 522 521 522 521 522 521 522 521 522 521 522 521 522 521 522 521 522 521 522 521 522 521 522 0 0 0 0 0 0 0 0 0 0 0 0 0 0 0 0
56 57 0 0 0 0 0 0 0 0 0 0 0 0 0 0 0 0 60 61 56 57 0 0 0 0 0 0 0 0 0 0 0 0 0 0 0 0 60 61 56 57 0 0 0 0 0 0 0 0 0 0 0 0 0 0 0 0 60 61 324 325 326 327 328 329 325 326 327 328 329 325 326 327 328 329 325 326 327 328 329 325 326 327 328 329 325 326 327 328 329 325 326 327 328 329 325 326 327 328 329 325 326 327 328 329 325 326 749 750 749 750 749 750 749 750 749 750 537 538 539 537 538 539 537 538 539 537 538 539 537 538 539 537 538 539 537 538 539 483 484 483 484 483 484 483 484 483 483 484 483 484 483 484 483 484 483 484 483 484 745 746 747 748 745 746 747 748 745 746 747 748 745 746 747 748 745 746 747 748 745 746 747 748 0 0 0 0 0 0 0 0 0 0 0 0 0 0 0 0

