TILEMAP
200 20        -- Size of tile map in tiles
16 16        -- Tile size & block size
textures/green_tile.png  -- Tilesheet
32 32         -- Number of tiles in tilesheet
0 0 0 0 0 0 0 0 0 0 563 564 565 566 567 568 563 564 565 566 567 568 563 564 565 566 567 568 563 564 565 566 567 568 563 564 565 566 567 568 563 564 565 566 567 568 563 564 565 566 567 568 563 564 565 566 567 568 563 564 565 566 567 568 563 564 565 566 567 568 563 564 565 566 567 568 563 564 565 566 567 568 563 564 565 566 567 568 563 564 565 566 567 568 563 564 565 566 567 568 563 564 565 566 567 568 563 564 565 566 567 568 563 564 565 566 567 568 563 564 565 566 567 568 563 564 565 566 567 568 563 564 565 566 567 568 563 564 565 566 567 568 563 564 565 566 567 568 563 564 565 566 567 568 563 564 565 566 567 568 563 564 565 566 567 568 563 564 565 566 567 568 563 564 565 566 567 568 563 564 565 566 567 568 563 564 565 566 567 0 0 0 0 0 0 0 0 0 0 0
0 0 0 0 0 0 0 0 0 0 595 596 597 598 599 600 595 596 597 598 599 600 595 596 597 598 599 600 595 596 597 598 599 600 595 596 597 598 599 600 595 596 597 598 599 600 595 596 597 598 599 600 595 596 597 598 599 600 595 596 597 598 599 600 595 596 597 598 599 600 595 596 597 598 599 600 595 596 597 598 599 600 595 596 597 598 599 600 595 596 597 598 599 600 595 596 597 598 599 600 595 596 597 598 599 600 595 596 597 598 599 600 595 596 597 598 599 600 595 596 597 598 599 600 595 596 597 598 599 600 595 596 597 598 599 600 595 596 597 598 599 600 595 596 597 598 599 600 595 596 597 598 599 600 595 596 597 598 599 600 595 596 597 598 599 600 595 596 597 598 599 600 595 596 597 598 599 600 595 596 597 598 599 600 595 596 597 598 599 0 0 0 0 0 0 0 0 0 0 0
0 0 0 0 0 0 0 0 0 0 0 0 0 0 0 0 0 0 0 0 0 0 0 0 0 0 0 0 0 0 0 0 0 0 0 0 0 0 0 0 0 0 0 0 0 0 0 0 0 139 139 0 0 0 0 0 0 0 0 0 0 0 0 0 0 0 0 0 0 0 0 0 0 0 0 0 0 0 0 0 0 0 0 0 0 0 0 0 0 0 0 0 0 0 0 946 947 946 947 946 947 946 947 946 947 946 947 946 947 946 947 946 947 946 947 946 947 946 947 946 947 946 947 946 947 946 947 946 947 946 947 946 947 946 947 946 947 946 947 946 947 946 947 946 947 946 947 946 947 946 947 946 947 946 947 946 947 946 947 946 947 946 947 946 947 946 947 946 947 946 947 946 947 946 947 946 947 946 947 946 947 946 947 946 947 946 947 946 947 0 0 0 0 0 0 0 0 0 0 0
0 0 0 0 0 0 0 0 0 0 139 139 139 139 139 139 139 139 139 139 139 139 139 139 139 139 139 139 139 139 139 139 139 139 139 139 139 139 139 139 139 139 139 139 139 139 139 139 139 139 139 0 40 0 0 0 0 0 0 364 0 0 0 0 0 0 40 0 0 0 0 0 364 0 0 0 0 40 0 0 0 364 0 0 0 40 0 0 0 364 0 0 0 40 0 978 979 978 979 978 979 978 979 978 979 978 979 978 979 978 979 978 979 978 979 978 979 978 979 978 979 978 979 978 979 978 979 978 979 978 979 978 979 978 979 978 979 978 979 978 979 978 979 978 979 978 979 978 979 978 979 978 979 978 979 978 979 978 979 978 979 978 979 978 979 978 979 978 979 978 979 978 979 978 979 978 979 978 979 978 979 978 979 978 979 978 979 978 979 0 0 0 0 0 0 0 0 0 0 0
0 0 0 0 0 0 0 0 0 0 139 0 0 0 0 0 0 0 0 0 0 0 0 0 0 0 0 0 0 0 0 0 0 0 0 0 0 0 0 0 0 0 0 0 0 0 0 0 0 0 0 806 807 808 0 40 40 0 806 807 808 0 40 40 0 806 807 808 40 40 0 806 807 808 40 40 806 807 808 0 806 807 808 0 806 807 808 0 806 807 808 0 806 807 808 0 0 0 0 0 0 0 0 0 0 0 0 0 0 0 0 0 0 0 0 0 0 0 0 0 0 0 0 0 0 0 0 0 0 0 0 0 0 0 0 0 0 0 0 0 0 0 0 0 0 0 0 0 0 0 0 0 0 0 0 0 0 0 0 0 0 0 0 0 0 0 0 0 0 0 0 0 0 0 0 0 0 0 0 0 0 0 0 0 0 0 0 0 0 0 0 0 0 0 0 0 0 0 0 0
0 0 0 0 0 0 0 0 0 0 139 0 0 0 0 139 139 139 139 139 139 139 139 139 139 139 139 139 139 0 0 0 0 0 0 0 0 0 0 0 0 0 0 0 0 0 0 0 0 0 0 838 201 840 0 9 9 0 838 201 840 0 9 9 0 838 201 840 9 9 0 838 201 840 9 9 838 201 840 0 838 201 840 0 838 201 840 0 838 201 840 0 838 201 840 883 884 883 884 883 884 883 884 883 884 883 884 883 884 883 884 883 884 883 884 883 884 883 884 883 884 883 884 883 884 883 884 883 884 883 884 883 884 883 884 883 884 883 884 883 884 883 884 883 884 883 884 883 884 883 884 883 884 883 884 883 884 883 884 883 884 883 884 883 884 883 884 883 884 883 884 883 884 883 884 883 884 883 884 883 884 883 884 883 884 883 884 883 884 0 0 0 0 0 0 0 0 0 0 0
0 0 0 0 0 0 0 0 0 0 139 0 0 0 0 139 0 0 0 0 0 0 0 0 0 0 0 0 139 0 0 0 0 0 0 0 0 0 0 139 139 0 0 0 0 0 0 0 0 0 0 870 871 872 0 0 0 0 870 871 872 0 0 0 0 870 871 872 0 0 0 870 871 872 0 0 870 871 872 0 870 871 872 0 870 871 872 0 870 871 872 0 870 871 872 915 916 915 916 915 916 915 916 915 916 915 916 915 916 915 916 915 916 915 916 915 916 915 916 915 916 915 916 915 916 915 916 915 916 915 916 915 916 915 916 915 916 915 916 915 916 915 916 915 916 915 916 915 916 915 916 915 916 915 916 915 916 915 916 915 916 915 916 915 916 915 916 915 916 915 916 915 916 915 916 915 916 915 916 915 916 915 916 915 916 915 916 915 916 0 0 0 0 0 0 0 0 0 0 0
0 0 0 0 0 0 0 0 0 0 139 0 0 0 0 139 0 0 0 0 0 0 0 0 0 0 0 0 139 0 0 0 0 0 0 0 0 0 201 139 139 0 0 0 0 0 0 0 0 0 0 0 9 0 0 0 0 0 0 333 0 0 0 0 0 0 9 0 0 0 0 0 333 0 0 0 0 9 0 0 0 333 0 0 0 9 0 0 0 333 0 0 0 0 0 0 722 722 722 722 722 722 722 722 722 722 722 722 722 722 722 722 722 722 722 722 722 722 722 722 722 722 722 722 722 722 722 722 722 722 722 722 722 722 722 722 722 722 722 722 722 722 722 722 722 722 722 722 722 722 722 722 722 722 722 722 722 722 722 722 722 722 722 722 722 722 722 722 722 722 722 722 722 722 722 722 722 722 722 722 722 722 722 722 722 722 722 722 722 0 0 0 0 0 0 0 0 0 0 0
0 0 0 0 0 0 0 0 0 0 139 0 0 0 0 0 0 0 0 0 0 0 0 0 0 0 0 0 0 0 0 0 0 0 0 0 0 201 139 139 139 0 0 0 0 0 0 0 0 0 0 0 0 0 0 0 0 0 0 0 0 0 0 0 0 0 0 0 0 0 0 0 0 0 0 0 0 0 0 0 0 0 0 0 0 0 0 0 0 0 0 0 0 0 0 0 0 0 0 0 0 0 0 0 0 0 0 0 0 0 0 0 0 0 0 0 0 0 0 0 0 0 0 0 0 0 0 0 0 0 0 0 0 0 0 0 0 0 0 0 0 0 0 0 0 0 0 0 0 0 0 0 0 0 0 0 0 0 0 0 0 0 0 0 0 0 0 0 0 0 0 0 0 0 0 0 0 0 0 0 0 0 0 0 0 0 0 0 0 0 0 0 0 0 0 0 0 0 0 0
0 0 0 0 0 0 0 0 0 0 0 0 0 0 0 0 0 0 0 0 0 0 0 0 0 0 0 0 0 0 0 0 0 0 0 0 201 139 139 139 139 0 0 0 0 0 0 0 0 0 0 0 0 0 0 0 0 0 0 0 0 0 0 0 0 0 0 0 0 0 0 0 0 0 0 0 0 0 0 0 0 0 0 0 0 0 0 0 0 0 0 0 0 0 0 0 0 0 0 0 0 0 0 0 0 0 0 0 0 0 0 0 0 0 0 0 0 0 0 0 0 0 0 0 0 0 0 0 0 0 0 0 0 0 0 0 0 0 0 0 0 0 0 0 0 0 0 0 0 0 0 0 0 0 0 0 0 0 0 0 0 0 0 0 0 0 0 0 0 0 0 0 0 0 0 0 0 0 0 0 0 0 0 0 0 0 0 0 0 0 0 0 0 0 0 0 0 0 0 0
0 0 0 0 0 0 0 0 0 0 0 0 0 0 0 0 139 139 139 139 139 139 139 139 139 139 139 139 139 0 0 0 0 0 0 201 139 139 0 139 139 0 0 0 0 0 0 0 0 0 0 0 40 0 0 0 0 0 0 364 0 0 0 0 0 0 40 0 0 0 0 0 364 0 0 0 0 40 0 0 0 364 0 0 0 40 0 0 0 364 0 0 0 40 0 0 0 0 0 0 0 0 0 0 0 0 0 0 0 0 0 0 0 0 0 0 0 0 0 0 0 0 0 0 0 0 0 0 0 0 0 0 0 0 0 0 0 0 0 0 0 0 0 0 0 0 0 0 0 0 0 0 0 0 0 0 0 0 0 0 0 0 0 0 0 0 0 0 0 0 0 0 0 0 0 0 0 0 0 0 0 0 0 0 0 0 0 0 0 0 0 0 0 0 0 0 0 0 0 0
0 0 0 0 0 0 0 0 0 0 139 0 0 0 0 0 139 139 139 139 139 139 139 139 139 139 139 139 139 0 0 0 0 0 201 139 139 0 0 139 139 0 0 0 0 0 0 0 0 0 0 806 807 808 0 0 0 0 806 807 808 0 0 0 0 806 807 808 0 0 0 806 807 808 0 0 806 807 808 0 806 807 808 0 806 807 808 0 806 807 808 0 806 807 808 0 722 722 722 722 722 722 722 722 722 722 722 722 722 722 722 722 722 722 722 722 722 722 722 722 722 722 722 722 722 722 722 722 722 722 722 722 722 722 722 722 722 722 722 722 722 722 722 722 722 722 722 722 722 722 722 722 722 722 722 722 722 722 722 722 722 722 722 722 722 722 722 722 722 722 722 722 722 722 722 722 722 722 722 722 722 722 722 722 722 722 722 722 722 0 0 0 0 0 0 0 0 0 0 0
0 0 0 0 0 0 0 0 0 0 139 0 0 0 0 0 0 0 0 0 0 0 0 0 0 0 0 0 0 0 0 0 0 201 139 139 0 0 0 139 139 0 0 0 0 0 0 0 0 0 0 838 201 840 0 40 40 0 838 201 840 0 40 40 0 838 201 840 40 40 0 838 201 840 40 40 838 201 840 0 838 201 840 0 838 201 840 0 838 201 840 0 838 201 840 883 884 883 884 883 884 883 884 883 884 883 884 883 884 883 884 883 884 883 884 883 884 883 884 883 884 883 884 883 884 883 884 883 884 883 884 883 884 883 884 883 884 883 884 883 884 883 884 883 884 883 884 883 884 883 884 883 884 883 884 883 884 883 884 883 884 883 884 883 884 883 884 883 884 883 884 883 884 883 884 883 884 883 884 883 884 883 884 883 884 883 884 883 884 0 0 0 0 0 0 0 0 0 0 0
0 0 0 0 0 0 0 0 0 0 139 0 0 0 0 0 0 0 0 0 0 0 0 0 0 0 0 0 0 0 0 0 201 139 139 0 0 0 0 139 139 0 0 0 0 0 0 0 0 0 0 870 871 872 0 9 9 0 870 871 872 0 9 9 0 870 871 872 9 9 0 870 871 872 9 9 870 871 872 0 870 871 872 0 870 871 872 0 870 871 872 0 870 871 872 915 916 915 916 915 916 915 916 915 916 915 916 915 916 915 916 915 916 915 916 915 916 915 916 915 916 915 916 915 916 915 916 915 916 915 916 915 916 915 916 915 916 915 916 915 916 915 916 915 916 915 916 915 916 915 916 915 916 915 916 915 916 915 916 915 916 915 916 915 916 915 916 915 916 915 916 915 916 915 916 915 916 915 916 915 916 915 916 915 916 915 916 915 916 0 0 0 0 0 0 0 0 0 0 0
0 0 0 0 0 0 0 0 0 0 139 139 139 139 139 139 139 139 139 139 139 139 139 139 139 139 139 139 139 139 139 139 139 139 139 139 139 139 139 139 139 139 139 139 139 139 139 139 139 139 139 0 9 0 0 0 0 0 0 333 0 0 0 0 0 0 9 0 0 0 0 0 333 0 0 0 0 9 0 0 0 333 0 0 0 9 0 0 0 333 0 0 0 9 0 0 0 0 0 0 0 0 0 0 0 0 0 0 0 0 0 0 0 0 0 0 0 0 0 0 0 0 0 0 0 0 0 0 0 0 0 0 0 0 0 0 0 0 0 0 0 0 0 0 0 0 0 0 0 0 0 0 0 0 0 0 0 0 0 0 0 0 0 0 0 0 0 0 0 0 0 0 0 0 0 0 0 0 0 0 0 0 0 0 0 0 0 0 0 0 0 0 0 0 0 0 0 0 0 0
0 0 0 0 0 0 0 0 0 0 140 141 140 141 140 141 140 141 140 141 0 0 0 0 0 0 0 0 0 0 0 0 0 0 0 0 0 0 0 0 0 0 0 0 0 0 0 0 0 139 139 0 0 0 0 0 0 0 0 0 0 0 0 0 0 0 0 0 0 0 0 0 0 0 0 0 0 0 0 0 0 0 0 0 0 0 0 0 0 0 0 0 0 0 0 0 0 0 0 0 0 0 0 0 0 0 0 0 0 0 0 0 0 0 0 0 0 0 0 0 0 0 0 0 0 0 0 0 0 0 0 0 0 0 0 0 0 0 0 0 0 0 0 0 0 0 0 0 0 0 0 0 0 0 0 0 0 0 0 0 0 0 0 0 0 0 0 0 0 0 0 0 0 0 0 0 0 0 0 0 0 0 0 0 0 0 0 0 0 0 0 0 0 0 0 0 0 0 0 0
0 0 0 0 0 0 0 0 0 0 172 173 172 173 172 173 172 173 172 173 0 0 0 0 0 0 0 0 0 0 0 0 0 0 0 0 0 0 0 0 0 0 0 0 0 0 0 0 0 139 139 944 945 944 945 944 945 944 945 944 945 944 945 944 945 944 945 944 945 944 945 944 945 944 945 944 945 944 945 944 945 944 945 944 945 944 945 944 945 944 945 944 945 944 945 946 947 946 947 946 947 946 947 946 947 946 947 946 947 946 947 946 947 946 947 946 947 946 947 946 947 946 947 946 947 946 947 946 947 946 947 946 947 946 947 946 947 946 947 946 947 946 947 946 947 946 947 946 947 946 947 946 947 946 947 946 947 946 947 946 947 946 947 946 947 946 947 946 947 946 947 946 947 946 947 946 947 946 947 946 947 946 947 946 947 946 947 946 947 0 0 0 0 0 0 0 0 0 0 0
0 0 0 0 0 0 0 0 0 0 0 0 0 0 0 0 0 0 0 0 0 0 0 0 0 0 0 0 0 0 0 0 0 0 0 0 0 0 0 0 0 0 0 0 0 0 0 0 0 139 139 976 977 976 977 976 977 976 977 976 977 976 977 976 977 976 977 976 977 976 977 976 977 976 977 976 977 976 977 976 977 976 977 976 977 976 977 976 977 976 977 976 977 976 977 978 979 978 979 978 979 978 979 978 979 978 979 978 979 978 979 978 979 978 979 978 979 978 979 978 979 978 979 978 979 978 979 978 979 978 979 978 979 978 979 978 979 978 979 978 979 978 979 978 979 978 979 978 979 978 979 978 979 978 979 978 979 978 979 978 979 978 979 978 979 978 979 978 979 978 979 978 979 978 979 978 979 978 979 978 979 978 979 978 979 978 979 978 979 0 0 0 0 0 0 0 0 0 0 0
0 0 0 0 0 0 0 0 0 0 761 762 761 762 761 762 761 762 761 762 761 762 761 762 761 762 761 762 761 762 761 762 761 762 761 762 761 762 761 762 761 762 761 762 761 762 761 762 761 762 761 762 761 762 761 762 761 762 761 762 761 762 761 762 761 762 761 762 761 762 761 762 761 762 761 762 761 762 761 762 761 762 761 762 761 762 761 762 761 762 761 762 761 762 761 762 761 762 761 762 761 762 761 762 761 762 761 762 761 762 761 762 761 762 761 762 761 762 761 762 761 762 761 762 761 762 761 762 761 762 761 762 761 762 761 762 761 762 761 762 761 762 761 762 761 762 761 762 761 762 761 762 761 762 761 762 761 762 761 762 761 762 761 762 761 762 761 762 761 762 761 762 761 762 761 762 761 762 761 762 761 762 761 762 761 762 761 762 761 0 0 0 0 0 0 0 0 0 0 0
0 0 0 0 0 0 0 0 0 0 793 794 793 794 793 794 793 794 793 794 793 794 793 794 793 794 793 794 793 794 793 794 793 794 793 794 793 794 793 794 793 794 793 794 793 794 793 794 793 794 793 794 793 794 793 794 793 794 793 794 793 794 793 794 793 794 793 794 793 794 793 794 793 794 793 794 793 794 793 794 793 794 793 794 793 794 793 794 793 794 793 794 793 794 793 794 793 794 793 794 793 794 793 794 793 794 793 794 793 794 793 794 793 794 793 794 793 794 793 794 793 794 793 794 793 794 793 794 793 794 793 794 793 794 793 794 793 794 793 794 793 794 793 794 793 794 793 794 793 794 793 794 793 794 793 794 793 794 793 794 793 794 793 794 793 794 793 794 793 794 793 794 793 794 793 794 793 794 793 794 793 794 793 794 793 794 793 794 793 0 0 0 0 0 0 0 0 0 0 0
